"member_id","round_id","teamValue","inTotal","outTotal","tradesTotal","CumTrades","remaining","cashcheck"
72028,1,1366800,1366800,0,-1366800,-1366800,21600,21600
72028,2,1420500,307900,310200,2300,-1364500,23900,23900
72028,3,1555400,159400,139400,-20000,-1384500,3900,3900
72028,4,1658000,0,0,0,-1384500,3900,3900
72031,1,1206300,1206300,0,-1206300,-1206300,182100,182100
72031,2,1190300,96700,96700,0,-1206300,182100,182100
72031,3,1352600,326100,154100,-172000,-1378300,10100,10100
72031,4,1369500,156500,147000,-9500,-1387800,600,600
72032,1,1387600,1387600,0,-1387600,-1387600,800,800
72032,2,1437300,281100,281800,700,-1386900,1500,1500
72032,3,1508700,129300,136500,7200,-1379700,8700,8700
72032,4,1567900,0,0,0,-1379700,8700,8700
72033,1,1376800,1376800,0,-1376800,-1376800,11600,11600
72033,2,1398000,0,0,0,-1376800,11600,11600
72033,3,1419900,0,0,0,-1376800,11600,11600
72033,4,1432600,0,0,0,-1376800,11600,11600
72034,1,1386800,1386800,0,-1386800,-1386800,1600,1600
72034,2,1448800,241500,242600,1100,-1385700,2700,2700
72034,3,1568600,149800,150000,200,-1385500,2900,2900
72034,4,1687200,131900,131000,-900,-1386400,2000,2000
72035,1,1386800,1386800,0,-1386800,-1386800,1600,1600
72035,2,1448800,241500,242600,1100,-1385700,2700,2700
72035,3,1569800,151000,150000,-1000,-1386700,1700,1700
72035,4,1685700,111100,112400,1300,-1385400,3000,3000
72036,1,1387800,1387800,0,-1387800,-1387800,600,600
72036,2,1447500,196000,201100,5100,-1382700,5700,5700
72036,3,1563900,155200,150800,-4400,-1387100,1300,1300
72036,4,1680000,143600,147100,3500,-1383600,4800,4800
72038,1,1384400,1384400,0,-1384400,-1384400,4000,4000
72038,2,1441700,219800,219500,-300,-1384700,3700,3700
72038,3,1567000,148100,145900,-2200,-1386900,1500,1500
72038,4,1692900,179200,181700,2500,-1384400,4000,4000
72040,1,1386900,1386900,0,-1386900,-1386900,1500,1500
72040,2,1450300,0,0,0,-1386900,1500,1500
72040,3,1555000,0,0,0,-1386900,1500,1500
72040,4,1662500,0,0,0,-1386900,1500,1500
72041,1,1380300,1380300,0,-1380300,-1380300,8100,8100
72041,2,1429600,162700,172400,9700,-1370600,17800,17800
72041,3,1532000,125700,142100,16400,-1354200,34200,34200
72041,4,1669400,150000,123100,-26900,-1381100,7300,7300
72042,1,1387800,1387800,0,-1387800,-1387800,600,600
72042,2,1435700,222300,227000,4700,-1383100,5300,5300
72042,3,1524500,220200,218600,-1600,-1384700,3700,3700
72042,4,1606500,107200,125400,18200,-1366500,21900,21900
72044,1,1382200,1382200,0,-1382200,-1382200,6200,6200
72044,2,1419900,238700,247800,9100,-1373100,15300,15300
72044,3,1509100,127100,145900,18800,-1354300,34100,34100
72044,4,1647200,144300,121800,-22500,-1376800,11600,11600
72045,1,1387600,1387600,0,-1387600,-1387600,800,800
72045,2,1442500,138600,142900,4300,-1383300,5100,5100
72045,3,1560500,166200,164000,-2200,-1385500,2900,2900
72045,4,1675500,159600,157000,-2600,-1388100,300,300
72046,1,1372400,1372400,0,-1372400,-1372400,16000,16000
72046,2,1420300,181600,182700,1100,-1371300,17100,17100
72046,3,1539400,205200,197500,-7700,-1379000,9400,9400
72046,4,1646300,169500,179200,9700,-1369300,19100,19100
72047,1,1386100,1386100,0,-1386100,-1386100,2300,2300
72047,2,1446700,213200,215200,2000,-1384100,4300,4300
72047,3,1529000,156500,196400,39900,-1344200,44200,44200
72047,4,1691500,140400,106000,-34400,-1378600,9800,9800
72048,1,1382400,1382400,0,-1382400,-1382400,6000,6000
72048,2,1401000,103600,112900,9300,-1373100,15300,15300
72048,3,1480000,153100,139600,-13500,-1386600,1800,1800
72048,4,1529600,147900,150900,3000,-1383600,4800,4800
72049,1,1386700,1386700,0,-1386700,-1386700,1700,1700
72049,2,1405800,73000,81700,8700,-1378000,10400,10400
72049,3,1483400,0,0,0,-1378000,10400,10400
72049,4,1547700,0,0,0,-1378000,10400,10400
72050,1,1356600,1356600,0,-1356600,-1356600,31800,31800
72050,2,1388000,113500,125500,12000,-1344600,43800,43800
72050,3,1501800,150300,136500,-13800,-1358400,30000,30000
72050,4,1593700,135700,127700,-8000,-1366400,22000,22000
72051,1,1384500,1384500,0,-1384500,-1384500,3900,3900
72051,2,1420100,110600,131100,20500,-1364000,24400,24400
72051,3,1539100,212400,188100,-24300,-1388300,100,100
72051,4,1641200,147400,150600,3200,-1385100,3300,3300
72052,1,1369400,1369400,0,-1369400,-1369400,19000,19000
72052,2,1413100,109900,91500,-18400,-1387800,600,600
72052,3,1474000,28700,40400,11700,-1376100,12300,12300
72052,4,1538100,0,0,0,-1376100,12300,12300
72053,1,1386600,1386600,0,-1386600,-1386600,1800,1800
72053,2,1415700,219800,231700,11900,-1374700,13700,13700
72053,3,1528100,209700,196200,-13500,-1388200,200,200
72053,4,1640000,208400,211100,2700,-1385500,2900,2900
72054,1,1380500,1380500,0,-1380500,-1380500,7900,7900
72054,2,1434500,343800,346200,2400,-1378100,10300,10300
72054,3,1544600,166400,164400,-2000,-1380100,8300,8300
72054,4,1665500,114700,127600,12900,-1367200,21200,21200
72056,1,1372900,1372900,0,-1372900,-1372900,15500,15500
72056,2,1422600,0,0,0,-1372900,15500,15500
72056,3,1519500,140800,132700,-8100,-1381000,7400,7400
72056,4,1600700,0,0,0,-1381000,7400,7400
72057,1,1367100,1367100,0,-1367100,-1367100,21300,21300
72057,2,1410600,0,0,0,-1367100,21300,21300
72057,3,1500700,250100,241100,-9000,-1376100,12300,12300
72057,4,1609100,199800,209200,9400,-1366700,21700,21700
72058,1,1379700,1379700,0,-1379700,-1379700,8700,8700
72058,2,1401800,48400,41200,-7200,-1386900,1500,1500
72058,3,1426500,202200,211400,9200,-1377700,10700,10700
72058,4,1517800,126100,117200,-8900,-1386600,1800,1800
72060,1,1365900,1365900,0,-1365900,-1365900,22500,22500
72060,2,1400700,113100,139500,26400,-1339500,48900,48900
72060,3,1547500,184900,136500,-48400,-1387900,500,500
72060,4,1623600,104200,129800,25600,-1362300,26100,26100
72061,1,1385600,1385600,0,-1385600,-1385600,2800,2800
72061,2,1432400,224300,235900,11600,-1374000,14400,14400
72061,3,1554600,171700,171800,100,-1373900,14500,14500
72061,4,1703200,237500,228000,-9500,-1383400,5000,5000
72064,1,1359100,1359100,0,-1359100,-1359100,29300,29300
72064,2,1389000,181600,208000,26400,-1332700,55700,55700
72064,3,1532900,239100,196300,-42800,-1375500,12900,12900
72064,4,1642100,0,0,0,-1375500,12900,12900
72066,1,1383000,1383000,0,-1383000,-1383000,5400,5400
72066,2,1427300,179900,192300,12400,-1370600,17800,17800
72066,3,1543000,217200,202000,-15200,-1385800,2600,2600
72066,4,1657700,329300,329000,-300,-1386100,2300,2300
72067,1,1384900,1384900,0,-1384900,-1384900,3500,3500
72067,2,1410000,152100,177400,25300,-1359600,28800,28800
72067,3,1549900,184900,156400,-28500,-1388100,300,300
72067,4,1659800,0,0,0,-1388100,300,300
72068,1,1384700,1384700,0,-1384700,-1384700,3700,3700
72068,2,1420800,0,0,0,-1384700,3700,3700
72068,3,1470500,0,0,0,-1384700,3700,3700
72068,4,1520800,0,0,0,-1384700,3700,3700
72069,1,1387600,1387600,0,-1387600,-1387600,800,800
72069,2,1434100,218100,228200,10100,-1377500,10900,10900
72069,3,1562900,268600,258200,-10400,-1387900,500,500
72069,4,1692600,154000,158300,4300,-1383600,4800,4800
72071,1,1378900,1378900,0,-1378900,-1378900,9500,9500
72071,2,1402600,197800,202000,4200,-1374700,13700,13700
72071,3,1481200,218700,212500,-6200,-1380900,7500,7500
72071,4,1566100,162100,155900,-6200,-1387100,1300,1300
72073,1,1380000,1380000,0,-1380000,-1380000,8400,8400
72073,2,1431400,187400,179400,-8000,-1388000,400,400
72073,3,1483300,153700,180400,26700,-1361300,27100,27100
72073,4,1580400,227100,205100,-22000,-1383300,5100,5100
72075,1,1385400,1385400,0,-1385400,-1385400,3000,3000
72075,2,1413400,113200,136400,23200,-1362200,26200,26200
72075,3,1527300,172700,151400,-21300,-1383500,4900,4900
72075,4,1627100,35900,47500,11600,-1371900,16500,16500
72076,1,602700,602700,0,-602700,-602700,785700,785700
72076,2,913600,368100,86100,-282000,-884700,503700,503700
72076,3,1201400,337900,86100,-251800,-1136500,251900,251900
72076,4,1508800,343300,92400,-250900,-1387400,1000,1000
72077,1,1386100,1386100,0,-1386100,-1386100,2300,2300
72077,2,1378600,243200,299200,56000,-1330100,58300,58300
72077,3,1516000,191100,150000,-41100,-1371200,17200,17200
72077,4,1614500,94000,89600,-4400,-1375600,12800,12800
72079,1,1376400,1376400,0,-1376400,-1376400,12000,12000
72079,2,1435300,0,0,0,-1376400,12000,12000
72079,3,1541700,0,0,0,-1376400,12000,12000
72079,4,1658300,0,0,0,-1376400,12000,12000
72080,1,1375900,1375900,0,-1375900,-1375900,12500,12500
72080,2,1417100,113500,123200,9700,-1366200,22200,22200
72080,3,1497800,2e+05,214700,14700,-1351500,36900,36900
72080,4,1650600,194200,157300,-36900,-1388400,0,0
72081,1,1384200,1384200,0,-1384200,-1384200,4200,4200
72081,2,1438700,168600,171600,3000,-1381200,7200,7200
72081,3,1520500,152000,148700,-3300,-1384500,3900,3900
72081,4,1607900,115700,124900,9200,-1375300,13100,13100
72085,1,1387600,1387600,0,-1387600,-1387600,800,800
72085,2,1384200,290000,316900,26900,-1360700,27700,27700
72085,3,1442300,0,0,0,-1360700,27700,27700
72085,4,1502900,152400,134300,-18100,-1378800,9600,9600
72088,1,602700,602700,0,-602700,-602700,785700,785700
72088,2,632000,0,0,0,-602700,785700,785700
72088,3,670400,0,0,0,-602700,785700,785700
72088,4,697400,0,0,0,-602700,785700,785700
72089,1,1343600,1343600,0,-1343600,-1343600,44800,44800
72089,2,1420800,181600,162200,-19400,-1363000,25400,25400
72089,3,1555500,187100,164600,-22500,-1385500,2900,2900
72089,4,1638100,267200,284800,17600,-1367900,20500,20500
72090,1,1383800,1383800,0,-1383800,-1383800,4600,4600
72090,2,1437000,152600,152500,-100,-1383900,4500,4500
72090,3,1545100,233700,234900,1200,-1382700,5700,5700
72090,4,1683100,192300,205400,13100,-1369600,18800,18800
72091,1,1383200,1383200,0,-1383200,-1383200,5200,5200
72091,2,1428200,199400,207900,8500,-1374700,13700,13700
72091,3,1540900,219300,226300,7000,-1367700,20700,20700
72091,4,1651100,179700,192600,12900,-1354800,33600,33600
72092,1,1385200,1385200,0,-1385200,-1385200,3200,3200
72092,2,1411200,117400,157100,39700,-1345500,42900,42900
72092,3,1556400,206900,186500,-20400,-1365900,22500,22500
72092,4,1656400,108600,137300,28700,-1337200,51200,51200
72096,1,1374000,1374000,0,-1374000,-1374000,14400,14400
72096,2,1379500,286800,329000,42200,-1331800,56600,56600
72096,3,1537900,174700,120900,-53800,-1385600,2800,2800
72096,4,1631300,197900,213500,15600,-1370000,18400,18400
72098,1,1375000,1375000,0,-1375000,-1375000,13400,13400
72098,2,1314400,181600,309900,128300,-1246700,141700,141700
72098,3,1572800,274900,136500,-138400,-1385100,3300,3300
72098,4,1696500,188200,192800,4600,-1380500,7900,7900
72099,1,1368300,1368300,0,-1368300,-1368300,20100,20100
72099,2,1446300,175600,157100,-18500,-1386800,1600,1600
72099,3,1561700,164500,163200,-1300,-1388100,300,300
72099,4,1666400,166100,190400,24300,-1363800,24600,24600
72100,1,1383700,1383700,0,-1383700,-1383700,4700,4700
72100,2,1424100,181600,202700,21100,-1362600,25800,25800
72100,3,1539600,132100,140200,8100,-1354500,33900,33900
72100,4,1698700,163500,131200,-32300,-1386800,1600,1600
72101,1,1375900,1375900,0,-1375900,-1375900,12500,12500
72101,2,1415600,230100,237100,7000,-1368900,19500,19500
72101,3,1539600,166300,151000,-15300,-1384200,4200,4200
72101,4,1668200,148600,145600,-3000,-1387200,1200,1200
72103,1,1387400,1387400,0,-1387400,-1387400,1000,1000
72103,2,1430900,202400,206000,3600,-1383800,4600,4600
72103,3,1526800,147400,151000,3600,-1380200,8200,8200
72103,4,1606900,118300,151500,33200,-1347000,41400,41400
72104,1,1324500,1324500,0,-1324500,-1324500,63900,63900
72104,2,1427500,213800,155000,-58800,-1383300,5100,5100
72104,3,1505200,86100,98800,12700,-1370600,17800,17800
72104,4,1556000,161500,169400,7900,-1362700,25700,25700
72106,1,1374800,1374800,0,-1374800,-1374800,13600,13600
72106,2,1419600,241500,266400,24900,-1349900,38500,38500
72106,3,1564300,220000,184700,-35300,-1385200,3200,3200
72106,4,1689600,186400,184100,-2300,-1387500,900,900
72108,1,1373300,1373300,0,-1373300,-1373300,15100,15100
72108,2,1417200,159000,175200,16200,-1357100,31300,31300
72108,3,1540500,147600,142400,-5200,-1362300,26100,26100
72108,4,1677600,192300,178600,-13700,-1376000,12400,12400
72109,1,1378700,1378700,0,-1378700,-1378700,9700,9700
72109,2,1435500,238700,237100,-1600,-1380300,8100,8100
72109,3,1549700,183800,186500,2700,-1377600,10800,10800
72109,4,1671500,114000,117000,3000,-1374600,13800,13800
72111,1,1365700,1365700,0,-1365700,-1365700,22700,22700
72111,2,1371900,0,0,0,-1365700,22700,22700
72111,3,1385800,0,0,0,-1365700,22700,22700
72111,4,1407300,0,0,0,-1365700,22700,22700
72112,1,1383700,1383700,0,-1383700,-1383700,4700,4700
72112,2,1408500,159000,187500,28500,-1355200,33200,33200
72112,3,1551900,175400,142400,-33000,-1388200,200,200
72112,4,1650500,194200,201100,6900,-1381300,7100,7100
72113,1,1378800,1378800,0,-1378800,-1378800,9600,9600
72113,2,1438200,159000,161300,2300,-1376500,11900,11900
72113,3,1544200,201900,213100,11200,-1365300,23100,23100
72113,4,1685500,137100,122000,-15100,-1380400,8000,8000
72114,1,1366200,1366200,0,-1366200,-1366200,22200,22200
72114,2,1431800,0,0,0,-1366200,22200,22200
72114,3,1532200,0,0,0,-1366200,22200,22200
72114,4,1623500,0,0,0,-1366200,22200,22200
72115,1,1341800,1341800,0,-1341800,-1341800,46600,46600
72115,2,1413000,225700,207000,-18700,-1360500,27900,27900
72115,3,1533700,172700,145900,-26800,-1387300,1100,1100
72115,4,1641000,119700,119500,-200,-1387500,900,900
72119,1,1380500,1380500,0,-1380500,-1380500,7900,7900
72119,2,1411900,181600,210500,28900,-1351600,36800,36800
72119,3,1576300,193400,160300,-33100,-1384700,3700,3700
72119,4,1674100,104100,137300,33200,-1351500,36900,36900
72120,1,1363500,1363500,0,-1363500,-1363500,24900,24900
72120,2,1409900,181600,176000,-5600,-1369100,19300,19300
72120,3,1511300,172700,179900,7200,-1361900,26500,26500
72120,4,1637200,0,0,0,-1361900,26500,26500
72121,1,1378600,1378600,0,-1378600,-1378600,9800,9800
72121,2,1439300,175100,172000,-3100,-1381700,6700,6700
72121,3,1547700,0,0,0,-1381700,6700,6700
72121,4,1661800,0,0,0,-1381700,6700,6700
72122,1,1381000,1381000,0,-1381000,-1381000,7400,7400
72122,2,1398900,0,0,0,-1381000,7400,7400
72122,3,1411500,0,0,0,-1381000,7400,7400
72122,4,1418600,0,0,0,-1381000,7400,7400
72123,1,1384700,1384700,0,-1384700,-1384700,3700,3700
72123,2,1447600,1e+05,97100,-2900,-1387600,800,800
72123,3,1547900,140800,145900,5100,-1382500,5900,5900
72123,4,1658200,157100,157800,700,-1381800,6600,6600
72124,1,1378800,1378800,0,-1378800,-1378800,9600,9600
72124,2,1434600,167200,162500,-4700,-1383500,4900,4900
72124,3,1524400,197300,196000,-1300,-1384800,3600,3600
72124,4,1614800,170300,173800,3500,-1381300,7100,7100
72125,1,1379800,1379800,0,-1379800,-1379800,8600,8600
72125,2,1428600,183700,176200,-7500,-1387300,1100,1100
72125,3,1517900,0,0,0,-1387300,1100,1100
72125,4,1613600,134800,138600,3800,-1383500,4900,4900
72127,1,1378700,1378700,0,-1378700,-1378700,9700,9700
72127,2,1460900,113500,105200,-8300,-1387000,1400,1400
72127,3,1549100,176100,191400,15300,-1371700,16700,16700
72127,4,1651700,176800,171800,-5000,-1376700,11700,11700
72128,1,1386000,1386000,0,-1386000,-1386000,2400,2400
72128,2,1432800,273300,271700,-1600,-1387600,800,800
72128,3,1519000,181600,198600,17000,-1370600,17800,17800
72128,4,1654400,134900,121700,-13200,-1383800,4600,4600
72129,1,1342400,1342400,0,-1342400,-1342400,46000,46000
72129,2,1438100,241500,210000,-31500,-1373900,14500,14500
72129,3,1546600,135200,135200,0,-1373900,14500,14500
72129,4,1641800,116800,140600,23800,-1350100,38300,38300
72130,1,1375000,1375000,0,-1375000,-1375000,13400,13400
72130,2,1445800,223500,211300,-12200,-1387200,1200,1200
72130,3,1558600,183800,186500,2700,-1384500,3900,3900
72130,4,1670300,197800,203700,5900,-1378600,9800,9800
72131,1,1360500,1360500,0,-1360500,-1360500,27900,27900
72131,2,1411900,0,0,0,-1360500,27900,27900
72131,3,1518600,190600,174300,-16300,-1376800,11600,11600
72131,4,1631600,0,0,0,-1376800,11600,11600
72132,1,1375400,1375400,0,-1375400,-1375400,13000,13000
72132,2,1447400,159000,152500,-6500,-1381900,6500,6500
72132,3,1527700,156500,180500,24000,-1357900,30500,30500
72132,4,1676300,177300,150600,-26700,-1384600,3800,3800
72133,1,1361700,1361700,0,-1361700,-1361700,26700,26700
72133,2,1400000,0,0,0,-1361700,26700,26700
72133,3,1450600,0,0,0,-1361700,26700,26700
72133,4,1505800,0,0,0,-1361700,26700,26700
72136,1,1371800,1371800,0,-1371800,-1371800,16600,16600
72136,2,1419800,164100,151300,-12800,-1384600,3800,3800
72136,3,1500100,0,0,0,-1384600,3800,3800
72136,4,1580300,188100,186600,-1500,-1386100,2300,2300
72138,1,1388200,1388200,0,-1388200,-1388200,200,200
72138,2,1441700,246300,265100,18800,-1369400,19000,19000
72138,3,1570200,149800,139400,-10400,-1379800,8600,8600
72138,4,1693000,256500,253300,-3200,-1383000,5400,5400
72139,1,1378000,1378000,0,-1378000,-1378000,10400,10400
72139,2,1419100,200900,197600,-3300,-1381300,7100,7100
72139,3,1508500,138500,141100,2600,-1378700,9700,9700
72139,4,1601300,0,0,0,-1378700,9700,9700
72140,1,1381200,1381200,0,-1381200,-1381200,7200,7200
72140,2,1415200,39700,67000,27300,-1353900,34500,34500
72140,3,1537000,92400,67400,-25000,-1378900,9500,9500
72140,4,1649200,0,0,0,-1378900,9500,9500
72141,1,1373800,1373800,0,-1373800,-1373800,14600,14600
72141,2,1428200,236600,226400,-10200,-1384000,4400,4400
72141,3,1507000,232500,247500,15000,-1369000,19400,19400
72141,4,1618800,201000,192600,-8400,-1377400,11000,11000
72143,1,1377400,1377400,0,-1377400,-1377400,11000,11000
72143,2,1422700,302000,293000,-9000,-1386400,2000,2000
72143,3,1484500,187000,227300,40300,-1346100,42300,42300
72143,4,1616600,316500,293200,-23300,-1369400,19000,19000
72145,1,1383400,1383400,0,-1383400,-1383400,5000,5000
72145,2,1435100,300500,301400,900,-1382500,5900,5900
72145,3,1529500,204300,199300,-5000,-1387500,900,900
72145,4,1626200,173900,182600,8700,-1378800,9600,9600
72146,1,1383300,1383300,0,-1383300,-1383300,5100,5100
72146,2,1417900,181600,186600,5000,-1378300,10100,10100
72146,3,1515000,0,0,0,-1378300,10100,10100
72146,4,1627700,183800,175900,-7900,-1386200,2200,2200
72148,1,1375400,1375400,0,-1375400,-1375400,13000,13000
72148,2,1381100,0,0,0,-1375400,13000,13000
72148,3,1369400,0,0,0,-1375400,13000,13000
72148,4,1362300,0,0,0,-1375400,13000,13000
72149,1,1380800,1380800,0,-1380800,-1380800,7600,7600
72149,2,1428100,268400,278000,9600,-1371200,17200,17200
72149,3,1549200,287900,286600,-1300,-1372500,15900,15900
72149,4,1690400,138800,123200,-15600,-1388100,300,300
72150,1,1354000,1354000,0,-1354000,-1354000,34400,34400
72150,2,1404800,0,0,0,-1354000,34400,34400
72150,3,1489200,149600,142400,-7200,-1361200,27200,27200
72150,4,1600800,122800,118400,-4400,-1365600,22800,22800
72151,1,1382100,1382100,0,-1382100,-1382100,6300,6300
72151,2,1438700,177700,186400,8700,-1373400,15000,15000
72151,3,1575800,193600,180600,-13000,-1386400,2000,2000
72151,4,1699800,235000,233600,-1400,-1387800,600,600
72152,1,1386000,1386000,0,-1386000,-1386000,2400,2400
72152,2,1429000,0,0,0,-1386000,2400,2400
72152,3,1507400,0,0,0,-1386000,2400,2400
72152,4,1577700,0,0,0,-1386000,2400,2400
72153,1,1367400,1367400,0,-1367400,-1367400,21000,21000
72153,2,1415400,240600,265500,24900,-1342500,45900,45900
72153,3,1567400,184100,144800,-39300,-1381800,6600,6600
72153,4,1677500,0,0,0,-1381800,6600,6600
72154,1,1388400,1388400,0,-1388400,-1388400,0,0
72154,2,1403700,217400,229700,12300,-1376100,12300,12300
72154,3,1467000,161300,181100,19800,-1356300,32100,32100
72154,4,1528000,164400,191500,27100,-1329200,59200,59200
72155,1,1381900,1381900,0,-1381900,-1381900,6500,6500
72155,2,1388900,113100,141800,28700,-1353200,35200,35200
72155,3,1509000,181200,147100,-34100,-1387300,1100,1100
72155,4,1611000,169500,181600,12100,-1375200,13200,13200
72157,1,1386600,1386600,0,-1386600,-1386600,1800,1800
72157,2,1417700,179200,185200,6000,-1380600,7800,7800
72157,3,1486400,0,0,0,-1380600,7800,7800
72157,4,1504400,226100,258400,32300,-1348300,40100,40100
72158,1,1377700,1377700,0,-1377700,-1377700,10700,10700
72158,2,1421900,236600,249600,13000,-1364700,23700,23700
72158,3,1563000,219200,197000,-22200,-1386900,1500,1500
72158,4,1694800,78300,79200,900,-1386000,2400,2400
72159,1,1381500,1381500,0,-1381500,-1381500,6900,6900
72159,2,1413000,169500,188500,19000,-1362500,25900,25900
72159,3,1524700,305900,287400,-18500,-1381000,7400,7400
72159,4,1642800,229200,227100,-2100,-1383100,5300,5300
72160,1,1385700,1385700,0,-1385700,-1385700,2700,2700
72160,2,1441400,294500,298300,3800,-1381900,6500,6500
72160,3,1559200,233200,234700,1500,-1380400,8000,8000
72160,4,1682300,0,0,0,-1380400,8000,8000
72161,1,1388400,1388400,0,-1388400,-1388400,0,0
72161,2,1387500,0,0,0,-1388400,0,0
72161,3,1391500,0,0,0,-1388400,0,0
72161,4,1382900,0,0,0,-1388400,0,0
72162,1,1383100,1383100,0,-1383100,-1383100,5300,5300
72162,2,1389000,0,0,0,-1383100,5300,5300
72162,3,1399400,0,0,0,-1383100,5300,5300
72162,4,1416100,0,0,0,-1383100,5300,5300
72163,1,1386700,1386700,0,-1386700,-1386700,1700,1700
72163,2,1439100,242000,242600,600,-1386100,2300,2300
72163,3,1540200,187600,199400,11800,-1374300,14100,14100
72163,4,1676700,168100,157700,-10400,-1384700,3700,3700
72164,1,1353200,1353200,0,-1353200,-1353200,35200,35200
72164,2,1413100,110100,91300,-18800,-1372000,16400,16400
72164,3,1509600,206300,199000,-7300,-1379300,9100,9100
72164,4,1602000,96400,117800,21400,-1357900,30500,30500
72166,1,1385700,1385700,0,-1385700,-1385700,2700,2700
72166,2,1412200,67800,71600,3800,-1381900,6500,6500
72166,3,1470100,174400,175200,800,-1381100,7300,7300
72166,4,1522900,0,0,0,-1381100,7300,7300
72167,1,1340000,1340000,0,-1340000,-1340000,48400,48400
72167,2,1371700,0,0,0,-1340000,48400,48400
72167,3,1442300,0,0,0,-1340000,48400,48400
72167,4,1512500,0,0,0,-1340000,48400,48400
72168,1,1373800,1373800,0,-1373800,-1373800,14600,14600
72168,2,1441800,240600,226400,-14200,-1388000,400,400
72168,3,1544700,149800,150800,1000,-1387000,1400,1400
72168,4,1650300,147300,146800,-500,-1387500,900,900
72172,1,1375400,1375400,0,-1375400,-1375400,13000,13000
72172,2,1392100,181600,211000,29400,-1346000,42400,42400
72172,3,1490900,0,0,0,-1346000,42400,42400
72172,4,1570000,0,0,0,-1346000,42400,42400
72173,1,1384700,1384700,0,-1384700,-1384700,3700,3700
72173,2,1434900,181600,189100,7500,-1377200,11200,11200
72173,3,1560700,206900,198500,-8400,-1385600,2800,2800
72173,4,1689900,158700,157000,-1700,-1387300,1100,1100
72176,1,1379400,1379400,0,-1379400,-1379400,9000,9000
72176,2,1441100,162700,161800,-900,-1380300,8100,8100
72176,3,1554000,193500,205600,12100,-1368200,20200,20200
72176,4,1697500,150200,131200,-19000,-1387200,1200,1200
72178,1,1387600,1387600,0,-1387600,-1387600,800,800
72178,2,1369600,162700,259500,96800,-1290800,97600,97600
72178,3,1577200,219900,137900,-82000,-1372800,15600,15600
72178,4,1685000,131900,165400,33500,-1339300,49100,49100
72180,1,1372200,1372200,0,-1372200,-1372200,16200,16200
72180,2,1418300,216900,219500,2600,-1369600,18800,18800
72180,3,1549500,198000,186500,-11500,-1381100,7300,7300
72180,4,1697700,145800,139500,-6300,-1387400,1000,1000
72182,1,1386900,1386900,0,-1386900,-1386900,1500,1500
72182,2,1436700,0,0,0,-1386900,1500,1500
72182,3,1470700,206300,209900,3600,-1383300,5100,5100
72182,4,1517000,221700,231100,9400,-1373900,14500,14500
72183,1,1373200,1373200,0,-1373200,-1373200,15200,15200
72183,2,1407500,219800,223800,4000,-1369200,19200,19200
72183,3,1527500,124100,108300,-15800,-1385000,3400,3400
72183,4,1632300,0,0,0,-1385000,3400,3400
72184,1,1350300,1350300,0,-1350300,-1350300,38100,38100
72184,2,1392000,0,0,0,-1350300,38100,38100
72184,3,1447400,0,0,0,-1350300,38100,38100
72184,4,1511700,0,0,0,-1350300,38100,38100
72186,1,1387700,1387700,0,-1387700,-1387700,700,700
72186,2,1435100,215000,216700,1700,-1386000,2400,2400
72186,3,1531200,202000,206400,4400,-1381600,6800,6800
72186,4,1638700,153800,156400,2600,-1379000,9400,9400
72187,1,1360600,1360600,0,-1360600,-1360600,27800,27800
72187,2,1433300,259600,233100,-26500,-1387100,1300,1300
72187,3,1527800,193700,198600,4900,-1382200,6200,6200
72187,4,1635300,166800,165400,-1400,-1383600,4800,4800
72188,1,1381800,1381800,0,-1381800,-1381800,6600,6600
72188,2,1389100,0,0,0,-1381800,6600,6600
72188,3,1381600,0,0,0,-1381800,6600,6600
72188,4,1382700,0,0,0,-1381800,6600,6600
72190,1,1379100,1379100,0,-1379100,-1379100,9300,9300
72190,2,1426400,197900,198600,700,-1378400,10000,10000
72190,3,1524400,133600,134400,800,-1377600,10800,10800
72190,4,1626100,213800,212500,-1300,-1378900,9500,9500
72191,1,1352800,1352800,0,-1352800,-1352800,35600,35600
72191,2,1427800,223400,215000,-8400,-1361200,27200,27200
72191,3,1552200,153300,142400,-10900,-1372100,16300,16300
72191,4,1693100,147700,134200,-13500,-1385600,2800,2800
72194,1,1386800,1386800,0,-1386800,-1386800,1600,1600
72194,2,1388400,262500,298600,36100,-1350700,37700,37700
72194,3,1494200,218400,199300,-19100,-1369800,18600,18600
72194,4,1569600,210800,226200,15400,-1354400,34000,34000
72198,1,1382200,1382200,0,-1382200,-1382200,6200,6200
72198,2,1409600,167600,192700,25100,-1357100,31300,31300
72198,3,1544600,131900,105300,-26600,-1383700,4700,4700
72198,4,1657700,154600,153300,-1300,-1385000,3400,3400
72199,1,1293500,1293500,0,-1293500,-1293500,94900,94900
72199,2,1301100,0,0,0,-1293500,94900,94900
72199,3,1316700,0,0,0,-1293500,94900,94900
72199,4,1320100,0,0,0,-1293500,94900,94900
72201,1,1382000,1382000,0,-1382000,-1382000,6400,6400
72201,2,1426800,114400,124600,10200,-1371800,16600,16600
72201,3,1517200,248400,247500,-900,-1372700,15700,15700
72201,4,1638800,161300,147300,-14000,-1386700,1700,1700
72204,1,1386600,1386600,0,-1386600,-1386600,1800,1800
72204,2,1436900,145700,147300,1600,-1385000,3400,3400
72204,3,1522900,128800,141300,12500,-1372500,15900,15900
72204,4,1626100,283300,277200,-6100,-1378600,9800,9800
72206,1,1377100,1377100,0,-1377100,-1377100,11300,11300
72206,2,1393300,177300,217900,40600,-1336500,51900,51900
72206,3,1544800,241700,191400,-50300,-1386800,1600,1600
72206,4,1640800,115900,134900,19000,-1367800,20600,20600
72207,1,1384000,1384000,0,-1384000,-1384000,4400,4400
72207,2,1439600,241500,261600,20100,-1363900,24500,24500
72207,3,1556200,160300,162500,2200,-1361700,26700,26700
72207,4,1703200,155300,141000,-14300,-1376000,12400,12400
72209,1,1385500,1385500,0,-1385500,-1385500,2900,2900
72209,2,1420500,157800,156200,-1600,-1387100,1300,1300
72209,3,1487500,0,0,0,-1387100,1300,1300
72209,4,1544300,0,0,0,-1387100,1300,1300
72211,1,1387200,1387200,0,-1387200,-1387200,1200,1200
72211,2,1408700,172100,206300,34200,-1353000,35400,35400
72211,3,1555300,176400,142400,-34000,-1387000,1400,1400
72211,4,1664300,111100,129200,18100,-1368900,19500,19500
72212,1,1378800,1378800,0,-1378800,-1378800,9600,9600
72212,2,1424100,243200,246100,2900,-1375900,12500,12500
72212,3,1550300,210700,199400,-11300,-1387200,1200,1200
72212,4,1671600,144600,145400,800,-1386400,2000,2000
72215,1,1332300,1332300,0,-1332300,-1332300,56100,56100
72215,2,1426900,113500,91300,-22200,-1354500,33900,33900
72215,3,1574100,175400,142400,-33000,-1387500,900,900
72215,4,1659700,119300,137300,18000,-1369500,18900,18900
72216,1,1388100,1388100,0,-1388100,-1388100,300,300
72216,2,1398000,0,0,0,-1388100,300,300
72216,3,1435400,0,0,0,-1388100,300,300
72216,4,1483300,0,0,0,-1388100,300,300
72217,1,1378900,1378900,0,-1378900,-1378900,9500,9500
72217,2,1428500,198000,195700,-2300,-1381200,7200,7200
72217,3,1528300,143200,136500,-6700,-1387900,500,500
72217,4,1599600,0,0,0,-1387900,500,500
72218,1,1381100,1381100,0,-1381100,-1381100,7300,7300
72218,2,1412300,198200,208500,10300,-1370800,17600,17600
72218,3,1506400,174700,159800,-14900,-1385700,2700,2700
72218,4,1590200,0,0,0,-1385700,2700,2700
72221,1,1387800,1387800,0,-1387800,-1387800,600,600
72221,2,1435200,241500,246100,4600,-1383200,5200,5200
72221,3,1554600,180800,179000,-1800,-1385000,3400,3400
72221,4,1681300,119600,116200,-3400,-1388400,0,0
72222,1,1385700,1385700,0,-1385700,-1385700,2700,2700
72222,2,1439300,157600,156100,-1500,-1387200,1200,1200
72222,3,1521200,258300,258600,300,-1386900,1500,1500
72222,4,1608300,0,0,0,-1386900,1500,1500
72223,1,1380400,1380400,0,-1380400,-1380400,8000,8000
72223,2,1417800,0,0,0,-1380400,8000,8000
72223,3,1495600,0,0,0,-1380400,8000,8000
72223,4,1573300,0,0,0,-1380400,8000,8000
72225,1,1369500,1369500,0,-1369500,-1369500,18900,18900
72225,2,1422000,200900,187600,-13300,-1382800,5600,5600
72225,3,1521100,152500,158200,5700,-1377100,11300,11300
72225,4,1627800,136000,135800,-200,-1377300,11100,11100
72227,1,1386800,1386800,0,-1386800,-1386800,1600,1600
72227,2,1431400,101000,99900,-1100,-1387900,500,500
72227,3,1499500,139200,142100,2900,-1385000,3400,3400
72227,4,1569700,0,0,0,-1385000,3400,3400
72232,1,1381500,1381500,0,-1381500,-1381500,6900,6900
72232,2,1389500,0,0,0,-1381500,6900,6900
72232,3,1395100,0,0,0,-1381500,6900,6900
72232,4,1412800,0,0,0,-1381500,6900,6900
72234,1,1387500,1387500,0,-1387500,-1387500,900,900
72234,2,1434600,265500,267000,1500,-1386000,2400,2400
72234,3,1509100,117500,140200,22700,-1363300,25100,25100
72234,4,1612200,189800,166600,-23200,-1386500,1900,1900
72235,1,1376300,1376300,0,-1376300,-1376300,12100,12100
72235,2,1419800,0,0,0,-1376300,12100,12100
72235,3,1476000,0,0,0,-1376300,12100,12100
72235,4,1544400,0,0,0,-1376300,12100,12100
72239,1,1375800,1375800,0,-1375800,-1375800,12600,12600
72239,2,1372800,0,0,0,-1375800,12600,12600
72239,3,1405600,0,0,0,-1375800,12600,12600
72239,4,1455900,0,0,0,-1375800,12600,12600
72243,1,1387500,1387500,0,-1387500,-1387500,900,900
72243,2,1453100,281000,280400,-600,-1388100,300,300
72243,3,1539600,200200,2e+05,-200,-1388300,100,100
72243,4,1622300,0,0,0,-1388300,100,100
72247,1,1383500,1383500,0,-1383500,-1383500,4900,4900
72247,2,1380000,0,0,0,-1383500,4900,4900
72247,3,1371300,0,0,0,-1383500,4900,4900
72247,4,1363200,0,0,0,-1383500,4900,4900
72250,1,1386700,1386700,0,-1386700,-1386700,1700,1700
72250,2,1393000,162700,209700,47000,-1339700,48700,48700
72250,3,1555500,227300,181300,-46000,-1385700,2700,2700
72250,4,1672800,107200,123500,16300,-1369400,19000,19000
72251,1,1380000,1380000,0,-1380000,-1380000,8400,8400
72251,2,1398000,0,0,0,-1380000,8400,8400
72251,3,1439000,0,0,0,-1380000,8400,8400
72251,4,1494600,0,0,0,-1380000,8400,8400
72253,1,1371600,1371600,0,-1371600,-1371600,16800,16800
72253,2,1430700,0,0,0,-1371600,16800,16800
72253,3,1511100,0,0,0,-1371600,16800,16800
72253,4,1582500,0,0,0,-1371600,16800,16800
72254,1,1385200,1385200,0,-1385200,-1385200,3200,3200
72254,2,1441900,0,0,0,-1385200,3200,3200
72254,3,1531400,0,0,0,-1385200,3200,3200
72254,4,1636200,106900,105300,-1600,-1386800,1600,1600
72255,1,1305500,1305500,0,-1305500,-1305500,82900,82900
72255,2,1294900,0,0,0,-1305500,82900,82900
72255,3,1285500,0,0,0,-1305500,82900,82900
72255,4,1301600,0,0,0,-1305500,82900,82900
72260,1,1355600,1355600,0,-1355600,-1355600,32800,32800
72260,2,1408600,0,0,0,-1355600,32800,32800
72260,3,1470700,0,0,0,-1355600,32800,32800
72260,4,1532500,0,0,0,-1355600,32800,32800
72261,1,1381100,1381100,0,-1381100,-1381100,7300,7300
72261,2,1415300,0,0,0,-1381100,7300,7300
72261,3,1465400,0,0,0,-1381100,7300,7300
72261,4,1494700,0,0,0,-1381100,7300,7300
72263,1,1368300,1368300,0,-1368300,-1368300,20100,20100
72263,2,1441100,255800,246100,-9700,-1378000,10400,10400
72263,3,1492900,219000,278000,59000,-1319000,69400,69400
72263,4,1628500,244000,233700,-10300,-1329300,59100,59100
72264,1,1381000,1381000,0,-1381000,-1381000,7400,7400
72264,2,1450500,127500,120900,-6600,-1387600,800,800
72264,3,1558200,104000,105300,1300,-1386300,2100,2100
72264,4,1657900,163400,163400,0,-1386300,2100,2100
72265,1,1388400,1388400,0,-1388400,-1388400,0,0
72265,2,1427300,160100,177200,17100,-1371300,17100,17100
72265,3,1560400,201700,186500,-15200,-1386500,1900,1900
72265,4,1659400,149600,177700,28100,-1358400,30000,30000
72267,1,1383100,1383100,0,-1383100,-1383100,5300,5300
72267,2,1429900,174200,171700,-2500,-1385600,2800,2800
72267,3,1522500,130700,134000,3300,-1382300,6100,6100
72267,4,1634200,161600,157100,-4500,-1386800,1600,1600
72268,1,1370600,1370600,0,-1370600,-1370600,17800,17800
72268,2,1425100,223400,212200,-11200,-1381800,6600,6600
72268,3,1529700,199000,196400,-2600,-1384400,4000,4000
72268,4,1618500,111000,129800,18800,-1365600,22800,22800
72271,1,1384400,1384400,0,-1384400,-1384400,4000,4000
72271,2,1441700,0,0,0,-1384400,4000,4000
72271,3,1518800,0,0,0,-1384400,4000,4000
72271,4,1602800,0,0,0,-1384400,4000,4000
72273,1,1387400,1387400,0,-1387400,-1387400,1000,1000
72273,2,1390500,0,0,0,-1387400,1000,1000
72273,3,1376500,0,0,0,-1387400,1000,1000
72273,4,1387100,0,0,0,-1387400,1000,1000
72274,1,1380200,1380200,0,-1380200,-1380200,8200,8200
72274,2,1394900,92600,87400,-5200,-1385400,3000,3000
72274,3,1396100,0,0,0,-1385400,3000,3000
72274,4,1404600,56500,57500,1000,-1384400,4000,4000
72275,1,1386600,1386600,0,-1386600,-1386600,1800,1800
72275,2,1381400,0,0,0,-1386600,1800,1800
72275,3,1379200,0,0,0,-1386600,1800,1800
72275,4,1364700,0,0,0,-1386600,1800,1800
72277,1,1384800,1384800,0,-1384800,-1384800,3600,3600
72277,2,1391600,0,0,0,-1384800,3600,3600
72277,3,1405600,0,0,0,-1384800,3600,3600
72277,4,1416800,0,0,0,-1384800,3600,3600
72280,1,1382600,1382600,0,-1382600,-1382600,5800,5800
72280,2,1384800,0,0,0,-1382600,5800,5800
72280,3,1377400,0,0,0,-1382600,5800,5800
72280,4,1378900,0,0,0,-1382600,5800,5800
72283,1,1387100,1387100,0,-1387100,-1387100,1300,1300
72283,2,1380900,0,0,0,-1387100,1300,1300
72283,3,1393000,0,0,0,-1387100,1300,1300
72283,4,1382600,0,0,0,-1387100,1300,1300
72291,1,1388100,1388100,0,-1388100,-1388100,300,300
72291,2,1398700,0,0,0,-1388100,300,300
72291,3,1411900,0,0,0,-1388100,300,300
72291,4,1423900,0,0,0,-1388100,300,300
72292,1,1336400,1336400,0,-1336400,-1336400,52000,52000
72292,2,1348700,0,0,0,-1336400,52000,52000
72292,3,1369100,0,0,0,-1336400,52000,52000
72292,4,1390400,0,0,0,-1336400,52000,52000
72300,1,1369500,1369500,0,-1369500,-1369500,18900,18900
72300,2,1383700,0,0,0,-1369500,18900,18900
72300,3,1402200,0,0,0,-1369500,18900,18900
72300,4,1404400,0,0,0,-1369500,18900,18900
72301,1,1375700,1375700,0,-1375700,-1375700,12700,12700
72301,2,1380800,0,0,0,-1375700,12700,12700
72301,3,1376000,0,0,0,-1375700,12700,12700
72301,4,1376200,0,0,0,-1375700,12700,12700
72302,1,1355500,1355500,0,-1355500,-1355500,32900,32900
72302,2,1440400,241500,212100,-29400,-1384900,3500,3500
72302,3,1535100,206900,213100,6200,-1378700,9700,9700
72302,4,1628900,110800,131900,21100,-1357600,30800,30800
72311,1,1236700,1236700,0,-1236700,-1236700,151700,151700
72311,2,1261500,0,0,0,-1236700,151700,151700
72311,3,1299200,0,0,0,-1236700,151700,151700
72311,4,1328700,0,0,0,-1236700,151700,151700
72315,1,1387200,1387200,0,-1387200,-1387200,1200,1200
72315,2,1447000,156700,156000,-700,-1387900,500,500
72315,3,1538500,156500,186500,30000,-1357900,30500,30500
72315,4,1665900,0,0,0,-1357900,30500,30500
72323,1,1382700,1382700,0,-1382700,-1382700,5700,5700
72323,2,1394800,170000,181900,11900,-1370800,17600,17600
72323,3,1446500,0,0,0,-1370800,17600,17600
72323,4,1485900,0,0,0,-1370800,17600,17600
72325,1,1378600,1378600,0,-1378600,-1378600,9800,9800
72325,2,1442900,240600,240500,-100,-1378700,9700,9700
72325,3,1559100,0,0,0,-1378700,9700,9700
72325,4,1656200,0,0,0,-1378700,9700,9700
72327,1,1387300,1387300,0,-1387300,-1387300,1100,1100
72327,2,1435100,0,0,0,-1387300,1100,1100
72327,3,1516200,0,0,0,-1387300,1100,1100
72327,4,1595500,0,0,0,-1387300,1100,1100
72329,1,1382700,1382700,0,-1382700,-1382700,5700,5700
72329,2,1372100,0,0,0,-1382700,5700,5700
72329,3,1366400,0,0,0,-1382700,5700,5700
72329,4,1368300,0,0,0,-1382700,5700,5700
72331,1,1384300,1384300,0,-1384300,-1384300,4100,4100
72331,2,1363500,242300,307400,65100,-1319200,69200,69200
72331,3,1518300,217400,153900,-63500,-1382700,5700,5700
72331,4,1578500,142100,169500,27400,-1355300,33100,33100
72335,1,1351600,1351600,0,-1351600,-1351600,36800,36800
72335,2,1399500,159000,150800,-8200,-1359800,28600,28600
72335,3,1509500,220200,196000,-24200,-1384000,4400,4400
72335,4,1581500,146800,177600,30800,-1353200,35200,35200
72336,1,1385500,1385500,0,-1385500,-1385500,2900,2900
72336,2,1438300,223100,221200,-1900,-1387400,1000,1000
72336,3,1524400,107900,135400,27500,-1359900,28500,28500
72336,4,1672500,283600,258200,-25400,-1385300,3100,3100
72337,1,1377900,1377900,0,-1377900,-1377900,10500,10500
72337,2,1375000,219800,253300,33500,-1344400,44000,44000
72337,3,1466800,232300,235300,3000,-1341400,47000,47000
72337,4,1640000,182400,144200,-38200,-1379600,8800,8800
72338,1,1385400,1385400,0,-1385400,-1385400,3000,3000
72338,2,1394100,219800,233100,13300,-1372100,16300,16300
72338,3,1501800,267900,253200,-14700,-1386800,1600,1600
72338,4,1616700,165900,165200,-700,-1387500,900,900
72340,1,1388200,1388200,0,-1388200,-1388200,200,200
72340,2,1395400,0,0,0,-1388200,200,200
72340,3,1414700,0,0,0,-1388200,200,200
72340,4,1440000,0,0,0,-1388200,200,200
72341,1,1381400,1381400,0,-1381400,-1381400,7000,7000
72341,2,1453400,170300,163500,-6800,-1388200,200,200
72341,3,1558200,158300,162500,4200,-1384000,4400,4400
72341,4,1690000,118300,115600,-2700,-1386700,1700,1700
72363,1,1370900,1370900,0,-1370900,-1370900,17500,17500
72363,2,1436900,111400,97000,-14400,-1385300,3100,3100
72363,3,1545200,175300,177900,2600,-1382700,5700,5700
72363,4,1674800,0,0,0,-1382700,5700,5700
72364,1,1369900,1369900,0,-1369900,-1369900,18500,18500
72364,2,1354000,205900,273300,67400,-1302500,85900,85900
72364,3,1496600,359100,324700,-34400,-1336900,51500,51500
72364,4,1608200,113300,101200,-12100,-1349000,39400,39400
72371,1,1383200,1383200,0,-1383200,-1383200,5200,5200
72371,2,1423300,182800,181000,-1800,-1385000,3400,3400
72371,3,1514600,222800,227500,4700,-1380300,8100,8100
72371,4,1635000,159000,153100,-5900,-1386200,2200,2200
72372,1,1387000,1387000,0,-1387000,-1387000,1400,1400
72372,2,1381600,0,0,0,-1387000,1400,1400
72372,3,1396300,0,0,0,-1387000,1400,1400
72372,4,1400300,0,0,0,-1387000,1400,1400
72389,1,1385300,1385300,0,-1385300,-1385300,3100,3100
72389,2,1386300,0,0,0,-1385300,3100,3100
72389,3,1396300,0,0,0,-1385300,3100,3100
72389,4,1409100,0,0,0,-1385300,3100,3100
72391,1,1354500,1354500,0,-1354500,-1354500,33900,33900
72391,2,1410700,144200,133000,-11200,-1365700,22700,22700
72391,3,1517300,199200,186900,-12300,-1378000,10400,10400
72391,4,1599300,139700,173000,33300,-1344700,43700,43700
72393,1,1385600,1385600,0,-1385600,-1385600,2800,2800
72393,2,1396400,0,0,0,-1385600,2800,2800
72393,3,1410700,0,0,0,-1385600,2800,2800
72393,4,1431900,0,0,0,-1385600,2800,2800
72401,1,1382900,1382900,0,-1382900,-1382900,5500,5500
72401,2,1406400,162700,192100,29400,-1353500,34900,34900
72401,3,1561300,172100,142400,-29700,-1383200,5200,5200
72401,4,1674600,148100,153900,5800,-1377400,11000,11000
72402,1,1387200,1387200,0,-1387200,-1387200,1200,1200
72402,2,1377800,181600,233500,51900,-1335300,53100,53100
72402,3,1528800,319100,269200,-49900,-1385200,3200,3200
72402,4,1655100,221400,223700,2300,-1382900,5500,5500
72405,1,1386100,1386100,0,-1386100,-1386100,2300,2300
72405,2,1390500,293700,321200,27500,-1358600,29800,29800
72405,3,1508200,277900,248700,-29200,-1387800,600,600
72405,4,1595900,236100,258800,22700,-1365100,23300,23300
72408,1,1386000,1386000,0,-1386000,-1386000,2400,2400
72408,2,1390600,0,0,0,-1386000,2400,2400
72408,3,1413100,0,0,0,-1386000,2400,2400
72408,4,1422700,0,0,0,-1386000,2400,2400
72411,1,1381900,1381900,0,-1381900,-1381900,6500,6500
72411,2,1397200,92800,87500,-5300,-1387200,1200,1200
72411,3,1426200,97200,96100,-1100,-1388300,100,100
72411,4,1464700,0,0,0,-1388300,100,100
72413,1,1370900,1370900,0,-1370900,-1370900,17500,17500
72413,2,1372400,0,0,0,-1370900,17500,17500
72413,3,1350600,0,0,0,-1370900,17500,17500
72413,4,1340900,0,0,0,-1370900,17500,17500
72414,1,1388000,1388000,0,-1388000,-1388000,400,400
72414,2,1381600,0,0,0,-1388000,400,400
72414,3,1378400,0,0,0,-1388000,400,400
72414,4,1377200,0,0,0,-1388000,400,400
72416,1,1380100,1380100,0,-1380100,-1380100,8300,8300
72416,2,1403700,295400,301200,5800,-1374300,14100,14100
72416,3,1507100,228800,217200,-11600,-1385900,2500,2500
72416,4,1608600,134200,152300,18100,-1367800,20600,20600
72420,1,1380100,1380100,0,-1380100,-1380100,8300,8300
72420,2,1394200,0,0,0,-1380100,8300,8300
72420,3,1408700,0,0,0,-1380100,8300,8300
72420,4,1429600,0,0,0,-1380100,8300,8300
72423,1,1385400,1385400,0,-1385400,-1385400,3000,3000
72423,2,1440600,0,0,0,-1385400,3000,3000
72423,3,1510300,128800,135400,6600,-1378800,9600,9600
72423,4,1597600,200400,205700,5300,-1373500,14900,14900
72427,1,1387600,1387600,0,-1387600,-1387600,800,800
72427,2,1435200,181600,192000,10400,-1377200,11200,11200
72427,3,1546000,287500,284700,-2800,-1380000,8400,8400
72427,4,1677400,193400,186100,-7300,-1387300,1100,1100
72432,1,1387200,1387200,0,-1387200,-1387200,1200,1200
72432,2,1413600,132600,133000,400,-1386800,1600,1600
72432,3,1483800,189300,188700,-600,-1387400,1000,1000
72432,4,1552500,221300,222800,1500,-1385900,2500,2500
72433,1,1383700,1383700,0,-1383700,-1383700,4700,4700
72433,2,1417700,174700,201300,26600,-1357100,31300,31300
72433,3,1575600,163700,136500,-27200,-1384300,4100,4100
72433,4,1717800,278100,274600,-3500,-1387800,600,600
72438,1,1361100,1361100,0,-1361100,-1361100,27300,27300
72438,2,1432200,223400,206300,-17100,-1378200,10200,10200
72438,3,1546500,215500,213100,-2400,-1380600,7800,7800
72438,4,1648200,194200,191800,-2400,-1383000,5400,5400
72440,1,1387600,1387600,0,-1387600,-1387600,800,800
72440,2,1387600,0,0,0,-1387600,800,800
72440,3,1398900,0,0,0,-1387600,800,800
72440,4,1411600,0,0,0,-1387600,800,800
72441,1,1378400,1378400,0,-1378400,-1378400,10000,10000
72441,2,1363800,0,0,0,-1378400,10000,10000
72441,3,1354500,0,0,0,-1378400,10000,10000
72441,4,1325000,0,0,0,-1378400,10000,10000
72444,1,1383700,1383700,0,-1383700,-1383700,4700,4700
72444,2,1393400,0,0,0,-1383700,4700,4700
72444,3,1408300,0,0,0,-1383700,4700,4700
72444,4,1409600,0,0,0,-1383700,4700,4700
72451,1,1367900,1367900,0,-1367900,-1367900,20500,20500
72451,2,1356900,0,0,0,-1367900,20500,20500
72451,3,1336000,0,0,0,-1367900,20500,20500
72451,4,1330900,0,0,0,-1367900,20500,20500
72452,1,1388400,1388400,0,-1388400,-1388400,0,0
72452,2,1417700,253200,257300,4100,-1384300,4100,4100
72452,3,1510000,133600,131600,-2000,-1386300,2100,2100
72452,4,1583100,120300,119100,-1200,-1387500,900,900
72459,1,1384500,1384500,0,-1384500,-1384500,3900,3900
72459,2,1308600,241500,357500,116000,-1268500,119900,119900
72459,3,1536900,279500,163600,-115900,-1384400,4000,4000
72459,4,1621600,175200,195600,20400,-1364000,24400,24400
72460,1,1387500,1387500,0,-1387500,-1387500,900,900
72460,2,1376700,0,0,0,-1387500,900,900
72460,3,1361400,0,0,0,-1387500,900,900
72460,4,1340300,0,0,0,-1387500,900,900
72465,1,1382000,1382000,0,-1382000,-1382000,6400,6400
72465,2,1367000,0,0,0,-1382000,6400,6400
72465,3,1338400,0,0,0,-1382000,6400,6400
72465,4,1325900,0,0,0,-1382000,6400,6400
72467,1,1375100,1375100,0,-1375100,-1375100,13300,13300
72467,2,1391500,269200,309900,40700,-1334400,54000,54000
72467,3,1471800,174400,196000,21600,-1312800,75600,75600
72467,4,1652000,260500,201700,-58800,-1371600,16800,16800
72468,1,1384900,1384900,0,-1384900,-1384900,3500,3500
72468,2,1415500,223300,251300,28000,-1356900,31500,31500
72468,3,1538700,131300,116700,-14600,-1371500,16900,16900
72468,4,1660200,143700,129800,-13900,-1385400,3000,3000
72472,1,1195800,1195800,0,-1195800,-1195800,192600,192600
72472,2,1228500,0,0,0,-1195800,192600,192600
72472,3,1260300,0,0,0,-1195800,192600,192600
72472,4,1295300,0,0,0,-1195800,192600,192600
72474,1,1382100,1382100,0,-1382100,-1382100,6300,6300
72474,2,1437800,180000,189500,9500,-1372600,15800,15800
72474,3,1546300,127100,142400,15300,-1357300,31100,31100
72474,4,1643000,117500,148600,31100,-1326200,62200,62200
72479,1,1387600,1387600,0,-1387600,-1387600,800,800
72479,2,1404800,205100,223600,18500,-1369100,19300,19300
72479,3,1505600,177000,177100,100,-1369000,19400,19400
72479,4,1622500,222100,207800,-14300,-1383300,5100,5100
72480,1,1383900,1383900,0,-1383900,-1383900,4500,4500
72480,2,1442300,241500,240000,-1500,-1385400,3000,3000
72480,3,1544800,185100,196000,10900,-1374500,13900,13900
72480,4,1667000,100700,112400,11700,-1362800,25600,25600
72490,1,1388400,1388400,0,-1388400,-1388400,0,0
72490,2,1432100,181600,183900,2300,-1386100,2300,2300
72490,3,1518400,262900,282900,20000,-1366100,22300,22300
72490,4,1676300,207300,195600,-11700,-1377800,10600,10600
72491,1,1363200,1363200,0,-1363200,-1363200,25200,25200
72491,2,1441000,295600,270500,-25100,-1388300,100,100
72491,3,1539800,160500,160800,300,-1388000,400,400
72491,4,1618300,271400,296700,25300,-1362700,25700,25700
72492,1,1315600,1315600,0,-1315600,-1315600,72800,72800
72492,2,1305700,0,0,0,-1315600,72800,72800
72492,3,1313000,0,0,0,-1315600,72800,72800
72492,4,1308000,0,0,0,-1315600,72800,72800
72502,1,1387900,1387900,0,-1387900,-1387900,500,500
72502,2,1451600,270800,270400,-400,-1388300,100,100
72502,3,1432400,64100,183800,119700,-1268600,119800,119800
72502,4,1634200,296400,195700,-100700,-1369300,19100,19100
72505,1,1387100,1387100,0,-1387100,-1387100,1300,1300
72505,2,1406400,178100,190100,12000,-1375100,13300,13300
72505,3,1497100,190300,179600,-10700,-1385800,2600,2600
72505,4,1612400,0,0,0,-1385800,2600,2600
72506,1,1386600,1386600,0,-1386600,-1386600,1800,1800
72506,2,1373900,0,0,0,-1386600,1800,1800
72506,3,1368500,0,0,0,-1386600,1800,1800
72506,4,1366600,0,0,0,-1386600,1800,1800
72512,1,1388400,1388400,0,-1388400,-1388400,0,0
72512,2,1412300,224300,256400,32100,-1356300,32100,32100
72512,3,1564800,161300,136500,-24800,-1381100,7300,7300
72512,4,1710800,147900,141700,-6200,-1387300,1100,1100
72513,1,1388400,1388400,0,-1388400,-1388400,0,0
72513,2,1379200,0,0,0,-1388400,0,0
72513,3,1391500,0,0,0,-1388400,0,0
72513,4,1404100,0,0,0,-1388400,0,0
72514,1,1386400,1386400,0,-1386400,-1386400,2000,2000
72514,2,1437200,0,0,0,-1386400,2000,2000
72514,3,1510000,0,0,0,-1386400,2000,2000
72514,4,1578800,0,0,0,-1386400,2000,2000
72519,1,1371000,1371000,0,-1371000,-1371000,17400,17400
72519,2,1374600,39800,66400,26600,-1344400,44000,44000
72519,3,1469300,126400,91500,-34900,-1379300,9100,9100
72519,4,1554000,176500,167800,-8700,-1388000,400,400
72524,1,1386300,1386300,0,-1386300,-1386300,2100,2100
72524,2,1386200,0,0,0,-1386300,2100,2100
72524,3,1379100,0,0,0,-1386300,2100,2100
72524,4,1392200,0,0,0,-1386300,2100,2100
72531,1,1380300,1380300,0,-1380300,-1380300,8100,8100
72531,2,1438300,295800,301400,5600,-1374700,13700,13700
72531,3,1528200,142600,142100,-500,-1375200,13200,13200
72531,4,1624000,262200,263100,900,-1374300,14100,14100
72533,1,1387600,1387600,0,-1387600,-1387600,800,800
72533,2,1399100,0,0,0,-1387600,800,800
72533,3,1420400,0,0,0,-1387600,800,800
72533,4,1448500,0,0,0,-1387600,800,800
72534,1,1383700,1383700,0,-1383700,-1383700,4700,4700
72534,2,1388600,0,0,0,-1383700,4700,4700
72534,3,1416300,0,0,0,-1383700,4700,4700
72534,4,1448400,0,0,0,-1383700,4700,4700
72537,1,1388000,1388000,0,-1388000,-1388000,400,400
72537,2,1409700,268400,270100,1700,-1386300,2100,2100
72537,3,1493200,238900,242600,3700,-1382600,5800,5800
72537,4,1601700,117900,116900,-1000,-1383600,4800,4800
72538,1,1385600,1385600,0,-1385600,-1385600,2800,2800
72538,2,1430000,113500,127600,14100,-1371500,16900,16900
72538,3,1528700,70700,73700,3000,-1368500,19900,19900
72538,4,1653100,145800,131300,-14500,-1383000,5400,5400
72539,1,1369800,1369800,0,-1369800,-1369800,18600,18600
72539,2,1426800,192000,179300,-12700,-1382500,5900,5900
72539,3,1521300,145900,142100,-3800,-1386300,2100,2100
72539,4,1610400,180600,190200,9600,-1376700,11700,11700
72540,1,1352800,1352800,0,-1352800,-1352800,35600,35600
72540,2,1335200,181600,265800,84200,-1268600,119800,119800
72540,3,1457200,206900,213100,6200,-1262400,126000,126000
72540,4,1566100,107200,137300,30100,-1232300,156100,156100
72541,1,1370800,1370800,0,-1370800,-1370800,17600,17600
72541,2,1309800,141900,210900,69000,-1301800,86600,86600
72541,3,1367100,0,0,0,-1301800,86600,86600
72541,4,1411300,0,0,0,-1301800,86600,86600
72545,1,1360200,1360200,0,-1360200,-1360200,28200,28200
72545,2,1435600,219800,208000,-11800,-1372000,16400,16400
72545,3,1566700,247200,236000,-11200,-1383200,5200,5200
72545,4,1704200,245800,249200,3400,-1379800,8600,8600
72548,1,1381600,1381600,0,-1381600,-1381600,6800,6800
72548,2,1446000,176900,172000,-4900,-1386500,1900,1900
72548,3,1540600,294300,307100,12800,-1373700,14700,14700
72548,4,1657600,190700,188000,-2700,-1376400,12000,12000
72549,1,1382600,1382600,0,-1382600,-1382600,5800,5800
72549,2,1423800,236900,243700,6800,-1375800,12600,12600
72549,3,1505800,183700,207300,23600,-1352200,36200,36200
72549,4,1651900,193600,167800,-25800,-1378000,10400,10400
72552,1,1381000,1381000,0,-1381000,-1381000,7400,7400
72552,2,1404400,243200,270800,27600,-1353400,35000,35000
72552,3,1541000,296200,261800,-34400,-1387800,600,600
72552,4,1650200,222900,234600,11700,-1376100,12300,12300
72553,1,1388000,1388000,0,-1388000,-1388000,400,400
72553,2,1381900,0,0,0,-1388000,400,400
72553,3,1379400,0,0,0,-1388000,400,400
72553,4,1365500,0,0,0,-1388000,400,400
72556,1,1381100,1381100,0,-1381100,-1381100,7300,7300
72556,2,1433700,110500,106200,-4300,-1385400,3000,3000
72556,3,1516200,144200,142100,-2100,-1387500,900,900
72556,4,1594100,137300,139300,2000,-1385500,2900,2900
72557,1,1381300,1381300,0,-1381300,-1381300,7100,7100
72557,2,1412500,109600,126600,17000,-1364300,24100,24100
72557,3,1539700,180700,161700,-19000,-1383300,5100,5100
72557,4,1664200,119300,118200,-1100,-1384400,4000,4000
72560,1,1381900,1381900,0,-1381900,-1381900,6500,6500
72560,2,1451200,307900,302600,-5300,-1387200,1200,1200
72560,3,1514100,180800,231600,50800,-1336400,52000,52000
72560,4,1628900,0,0,0,-1336400,52000,52000
72563,1,1388200,1388200,0,-1388200,-1388200,200,200
72563,2,1446900,309800,322700,12900,-1375300,13100,13100
72563,3,1563700,206900,199400,-7500,-1382800,5600,5600
72563,4,1664800,110800,126800,16000,-1366800,21600,21600
72565,1,1288000,1288000,0,-1288000,-1288000,100400,100400
72565,2,1349100,191200,173500,-17700,-1305700,82700,82700
72565,3,1490300,291500,246600,-44900,-1350600,37800,37800
72565,4,1629600,171700,157200,-14500,-1365100,23300,23300
72566,1,1378300,1378300,0,-1378300,-1378300,10100,10100
72566,2,1437500,212400,206800,-5600,-1383900,4500,4500
72566,3,1539100,130500,135400,4900,-1379000,9400,9400
72566,4,1646100,154600,151700,-2900,-1381900,6500,6500
72567,1,1379500,1379500,0,-1379500,-1379500,8900,8900
72567,2,1412800,113100,141100,28000,-1351500,36900,36900
72567,3,1561100,168700,141900,-26800,-1378300,10100,10100
72567,4,1657800,176700,195600,18900,-1359400,29000,29000
72570,1,1383800,1383800,0,-1383800,-1383800,4600,4600
72570,2,1434300,295400,293000,-2400,-1386200,2200,2200
72570,3,1546600,161900,160600,-1300,-1387500,900,900
72570,4,1631400,156500,162500,6000,-1381500,6900,6900
72577,1,1386100,1386100,0,-1386100,-1386100,2300,2300
72577,2,1427300,240400,265100,24700,-1361400,27000,27000
72577,3,1536200,325000,318600,-6400,-1367800,20600,20600
72577,4,1668900,191600,172300,-19300,-1387100,1300,1300
72579,1,1364300,1364300,0,-1364300,-1364300,24100,24100
72579,2,1390100,0,0,0,-1364300,24100,24100
72579,3,1422000,0,0,0,-1364300,24100,24100
72579,4,1438400,0,0,0,-1364300,24100,24100
72580,1,1353300,1353300,0,-1353300,-1353300,35100,35100
72580,2,1432100,235700,204400,-31300,-1384600,3800,3800
72580,3,1524700,130700,140200,9500,-1375100,13300,13300
72580,4,1632200,288900,276300,-12600,-1387700,700,700
72582,1,1382000,1382000,0,-1382000,-1382000,6400,6400
72582,2,1420300,269000,269800,800,-1381200,7200,7200
72582,3,1525800,73300,67400,-5900,-1387100,1300,1300
72582,4,1639900,0,0,0,-1387100,1300,1300
72583,2,1335200,1335200,0,-1335200,-1335200,53200,53200
72583,3,1457400,0,0,0,-1335200,53200,53200
72583,4,1560100,0,0,0,-1335200,53200,53200
72584,1,1387100,1387100,0,-1387100,-1387100,1300,1300
72584,2,1384700,0,0,0,-1387100,1300,1300
72584,3,1382300,0,0,0,-1387100,1300,1300
72584,4,1410900,0,0,0,-1387100,1300,1300
72585,2,1386000,1386000,0,-1386000,-1386000,2400,2400
72585,3,1499800,144400,142100,-2300,-1388300,100,100
72585,4,1594500,119600,130300,10700,-1377600,10800,10800
72587,1,1380800,1380800,0,-1380800,-1380800,7600,7600
72587,2,1419800,0,0,0,-1380800,7600,7600
72587,3,1467600,198900,231000,32100,-1348700,39700,39700
72587,4,1541500,0,0,0,-1348700,39700,39700
72589,1,1387200,1387200,0,-1387200,-1387200,1200,1200
72589,2,1382400,137300,196800,59500,-1327700,60700,60700
72589,3,1504300,0,0,0,-1327700,60700,60700
72589,4,1619100,0,0,0,-1327700,60700,60700
72590,1,1384700,1384700,0,-1384700,-1384700,3700,3700
72590,2,1430000,201500,199900,-1600,-1386300,2100,2100
72590,3,1527900,145400,144400,-1000,-1387300,1100,1100
72590,4,1635700,0,0,0,-1387300,1100,1100
72591,1,1379600,1379600,0,-1379600,-1379600,8800,8800
72591,2,1429300,198000,201000,3000,-1376600,11800,11800
72591,3,1537500,229000,224300,-4700,-1381300,7100,7100
72591,4,1661400,141800,137300,-4500,-1385800,2600,2600
72593,1,1381900,1381900,0,-1381900,-1381900,6500,6500
72593,2,1450200,406400,401800,-4600,-1386500,1900,1900
72593,3,1540200,186400,196200,9800,-1376700,11700,11700
72593,4,1652100,203600,195200,-8400,-1385100,3300,3300
72594,1,1387300,1387300,0,-1387300,-1387300,1100,1100
72594,2,1410400,152200,161500,9300,-1378000,10400,10400
72594,3,1436600,156500,183100,26600,-1351400,37000,37000
72594,4,1545600,229700,192700,-37000,-1388400,0,0
72596,1,1386200,1386200,0,-1386200,-1386200,2200,2200
72596,2,1434200,0,0,0,-1386200,2200,2200
72596,3,1528200,217500,221600,4100,-1382100,6300,6300
72596,4,1585900,134600,196200,61600,-1320500,67900,67900
72600,1,1383600,1383600,0,-1383600,-1383600,4800,4800
72600,2,1434600,250100,259300,9200,-1374400,14000,14000
72600,3,1544100,0,0,0,-1374400,14000,14000
72600,4,1655800,0,0,0,-1374400,14000,14000
72601,1,1385900,1385900,0,-1385900,-1385900,2500,2500
72601,2,1408800,176100,194100,18000,-1367900,20500,20500
72601,3,1530200,182800,174600,-8200,-1376100,12300,12300
72601,4,1634700,214800,236200,21400,-1354700,33700,33700
72603,1,1383100,1383100,0,-1383100,-1383100,5300,5300
72603,2,1426900,168600,163400,-5200,-1388300,100,100
72603,3,1499000,70700,77000,6300,-1382000,6400,6400
72603,4,1590000,176300,175500,-800,-1382800,5600,5600
72605,1,1387900,1387900,0,-1387900,-1387900,500,500
72605,2,1438300,196000,200400,4400,-1383500,4900,4900
72605,3,1538900,146900,142400,-4500,-1388000,400,400
72605,4,1607300,102900,129400,26500,-1361500,26900,26900
72606,1,1387900,1387900,0,-1387900,-1387900,500,500
72606,2,1412100,220600,227600,7000,-1380900,7500,7500
72606,3,1488500,221100,217500,-3600,-1384500,3900,3900
72606,4,1526300,108600,142100,33500,-1351000,37400,37400
72609,1,1377500,1377500,0,-1377500,-1377500,10900,10900
72609,2,1415200,181600,207000,25400,-1352100,36300,36300
72609,3,1548000,236500,217500,-19000,-1371100,17300,17300
72609,4,1696300,151400,134500,-16900,-1388000,400,400
72610,1,1383400,1383400,0,-1383400,-1383400,5000,5000
72610,2,1406100,0,0,0,-1383400,5000,5000
72610,3,1446800,0,0,0,-1383400,5000,5000
72610,4,1484800,0,0,0,-1383400,5000,5000
72611,1,1384500,1384500,0,-1384500,-1384500,3900,3900
72611,2,1431700,0,0,0,-1384500,3900,3900
72611,3,1510900,0,0,0,-1384500,3900,3900
72611,4,1588600,0,0,0,-1384500,3900,3900
72612,1,1377900,1377900,0,-1377900,-1377900,10500,10500
72612,2,1430000,173800,175200,1400,-1376500,11900,11900
72612,3,1533000,184900,198200,13300,-1363200,25200,25200
72612,4,1668100,259400,234700,-24700,-1387900,500,500
72614,1,1385900,1385900,0,-1385900,-1385900,2500,2500
72614,2,1437800,224300,232000,7700,-1378200,10200,10200
72614,3,1575200,195300,186300,-9000,-1387200,1200,1200
72614,4,1712800,157800,165700,7900,-1379300,9100,9100
72615,1,1387900,1387900,0,-1387900,-1387900,500,500
72615,2,1445000,216900,216700,-200,-1388100,300,300
72615,3,1545000,152300,160600,8300,-1379800,8600,8600
72615,4,1671100,181400,173400,-8000,-1387800,600,600
72622,1,1386600,1386600,0,-1386600,-1386600,1800,1800
72622,2,1404700,233700,263600,29900,-1356700,31700,31700
72622,3,1536600,236300,213100,-23200,-1379900,8500,8500
72622,4,1656400,216100,211200,-4900,-1384800,3600,3600
72623,1,1306800,1306800,0,-1306800,-1306800,81600,81600
72623,2,1383200,238400,216800,-21600,-1328400,60000,60000
72623,3,1539900,172100,122700,-49400,-1377800,10600,10600
72623,4,1644200,177300,179800,2500,-1375300,13100,13100
72624,1,1368000,1368000,0,-1368000,-1368000,20400,20400
72624,2,1399500,224300,250100,25800,-1342200,46200,46200
72624,3,1542200,232500,213100,-19400,-1361600,26800,26800
72624,4,1675800,134900,134300,-600,-1362200,26200,26200
72630,1,1365400,1365400,0,-1365400,-1365400,23000,23000
72630,2,1422300,302000,312600,10600,-1354800,33600,33600
72630,3,1538900,331400,331800,400,-1354400,34000,34000
72630,4,1693900,172100,142400,-29700,-1384100,4300,4300
72631,1,1380200,1380200,0,-1380200,-1380200,8200,8200
72631,2,1427300,263600,270000,6400,-1373800,14600,14600
72631,3,1525800,326100,327100,1000,-1372800,15600,15600
72631,4,1640000,262500,260600,-1900,-1374700,13700,13700
72632,1,1387600,1387600,0,-1387600,-1387600,800,800
72632,2,1428600,0,0,0,-1387600,800,800
72632,3,1488100,0,0,0,-1387600,800,800
72632,4,1556300,0,0,0,-1387600,800,800
72633,1,1388100,1388100,0,-1388100,-1388100,300,300
72633,2,1363300,135600,158400,22800,-1365300,23100,23100
72633,3,1424500,241900,235000,-6900,-1372200,16200,16200
72633,4,1517600,288100,276200,-11900,-1384100,4300,4300
72634,1,1359000,1359000,0,-1359000,-1359000,29400,29400
72634,2,1372600,173400,199800,26400,-1332600,55800,55800
72634,3,1433900,161900,191400,29500,-1303100,85300,85300
72634,4,1537700,119300,128100,8800,-1294300,94100,94100
72635,1,1382400,1382400,0,-1382400,-1382400,6000,6000
72635,2,1402000,175100,173700,-1400,-1383800,4600,4600
72635,3,1424700,127700,146500,18800,-1365000,23400,23400
72635,4,1474200,186900,2e+05,13100,-1351900,36500,36500
72636,1,1376000,1376000,0,-1376000,-1376000,12400,12400
72636,2,1405900,217700,206600,-11100,-1387100,1300,1300
72636,3,1484700,171700,173300,1600,-1385500,2900,2900
72636,4,1578800,88900,93700,4800,-1380700,7700,7700
72639,1,1386100,1386100,0,-1386100,-1386100,2300,2300
72639,2,1433400,237700,237000,-700,-1386800,1600,1600
72639,3,1522300,215300,213700,-1600,-1388400,0,0
72639,4,1621000,0,0,0,-1388400,0,0
72641,1,1359100,1359100,0,-1359100,-1359100,29300,29300
72641,2,1403900,0,0,0,-1359100,29300,29300
72641,3,1482700,0,0,0,-1359100,29300,29300
72641,4,1581000,0,0,0,-1359100,29300,29300
72642,1,1375500,1375500,0,-1375500,-1375500,12900,12900
72642,2,1400800,0,0,0,-1375500,12900,12900
72642,3,1442000,0,0,0,-1375500,12900,12900
72642,4,1481200,217000,209300,-7700,-1383200,5200,5200
72643,1,1381700,1381700,0,-1381700,-1381700,6700,6700
72643,2,1440200,366900,362500,-4400,-1386100,2300,2300
72643,3,1533000,235300,253500,18200,-1367900,20500,20500
72643,4,1664300,244500,225400,-19100,-1387000,1400,1400
72644,1,1386400,1386400,0,-1386400,-1386400,2000,2000
72644,2,1426200,164000,165400,1400,-1385000,3400,3400
72644,3,1492900,151200,151200,0,-1385000,3400,3400
72644,4,1585300,48800,46000,-2800,-1387800,600,600
72646,1,1387000,1387000,0,-1387000,-1387000,1400,1400
72646,2,1439500,0,0,0,-1387000,1400,1400
72646,3,1516500,0,0,0,-1387000,1400,1400
72646,4,1591700,0,0,0,-1387000,1400,1400
72647,1,1380800,1380800,0,-1380800,-1380800,7600,7600
72647,2,1431900,213300,214700,1400,-1379400,9000,9000
72647,3,1535600,184500,182800,-1700,-1381100,7300,7300
72647,4,1606300,104200,133400,29200,-1351900,36500,36500
72648,1,1364600,1364600,0,-1364600,-1364600,23800,23800
72648,2,1399100,214000,192000,-22000,-1386600,1800,1800
72648,3,1465600,225900,234000,8100,-1378500,9900,9900
72648,4,1571000,158200,161900,3700,-1374800,13600,13600
72649,1,1388100,1388100,0,-1388100,-1388100,300,300
72649,2,1457800,132300,132800,500,-1387600,800,800
72649,3,1552800,155300,162500,7200,-1380400,8000,8000
72649,4,1668600,165500,163200,-2300,-1382700,5700,5700
72651,1,1381600,1381600,0,-1381600,-1381600,6800,6800
72651,2,1409400,239800,270800,31000,-1350600,37800,37800
72651,3,1521900,0,0,0,-1350600,37800,37800
72651,4,1638700,0,0,0,-1350600,37800,37800
72654,1,1378600,1378600,0,-1378600,-1378600,9800,9800
72654,2,1430000,219700,223800,4100,-1374500,13900,13900
72654,3,1552600,174700,168500,-6200,-1380700,7700,7700
72654,4,1656000,180500,173600,-6900,-1387600,800,800
72656,1,1361300,1361300,0,-1361300,-1361300,27100,27100
72656,2,1387400,181600,201100,19500,-1341800,46600,46600
72656,3,1534000,176100,134000,-42100,-1383900,4500,4500
72656,4,1645700,219200,216200,-3000,-1386900,1500,1500
72657,1,1388400,1388400,0,-1388400,-1388400,0,0
72657,2,1441900,90800,94600,3800,-1384600,3800,3800
72657,3,1520100,207800,210400,2600,-1382000,6400,6400
72657,4,1598700,260500,270600,10100,-1371900,16500,16500
72660,1,1388300,1388300,0,-1388300,-1388300,100,100
72660,2,1434500,212400,215700,3300,-1385000,3400,3400
72660,3,1537200,135300,135700,400,-1384600,3800,3800
72660,4,1644500,0,0,0,-1384600,3800,3800
72662,1,1357300,1357300,0,-1357300,-1357300,31100,31100
72662,2,1369500,194100,216700,22600,-1334700,53700,53700
72662,3,1446000,280600,295600,15000,-1319700,68700,68700
72662,4,1588200,175400,110400,-65000,-1384700,3700,3700
72664,1,1379400,1379400,0,-1379400,-1379400,9000,9000
72664,2,1434700,150700,141800,-8900,-1388300,100,100
72664,3,1496900,267900,279900,12000,-1376300,12100,12100
72664,4,1577400,255500,265600,10100,-1366200,22200,22200
72666,1,1386400,1386400,0,-1386400,-1386400,2000,2000
72666,2,1403900,217700,265500,47800,-1338600,49800,49800
72666,3,1559000,179300,134000,-45300,-1383900,4500,4500
72666,4,1674200,192600,192600,0,-1383900,4500,4500
72667,1,1373500,1373500,0,-1373500,-1373500,14900,14900
72667,2,1394600,0,0,0,-1373500,14900,14900
72667,3,1433900,0,0,0,-1373500,14900,14900
72667,4,1475100,0,0,0,-1373500,14900,14900
72668,1,1368400,1368400,0,-1368400,-1368400,20000,20000
72668,2,1381400,281200,293500,12300,-1356100,32300,32300
72668,3,1467100,0,0,0,-1356100,32300,32300
72668,4,1551400,0,0,0,-1356100,32300,32300
72669,1,1381200,1381200,0,-1381200,-1381200,7200,7200
72669,2,1376600,0,0,0,-1381200,7200,7200
72669,3,1375600,0,0,0,-1381200,7200,7200
72669,4,1377900,0,0,0,-1381200,7200,7200
72670,1,1379700,1379700,0,-1379700,-1379700,8700,8700
72670,2,1427600,220600,227800,7200,-1372500,15900,15900
72670,3,1534100,204700,217900,13200,-1359300,29100,29100
72670,4,1683900,264500,243300,-21200,-1380500,7900,7900
72671,1,1371900,1371900,0,-1371900,-1371900,16500,16500
72671,2,1412800,0,0,0,-1371900,16500,16500
72671,3,1503800,216000,203900,-12100,-1384000,4400,4400
72671,4,1576700,115400,157800,42400,-1341600,46800,46800
72672,1,1356200,1356200,0,-1356200,-1356200,32200,32200
72672,2,1410100,181600,186400,4800,-1351400,37000,37000
72672,3,1541700,232400,206400,-26000,-1377400,11000,11000
72672,4,1633300,100700,127900,27200,-1350200,38200,38200
72673,1,1385600,1385600,0,-1385600,-1385600,2800,2800
72673,2,1393000,345200,389800,44600,-1341000,47400,47400
72673,3,1509000,179000,143900,-35100,-1376100,12300,12300
72673,4,1598800,119700,121600,1900,-1374200,14200,14200
72674,1,1322200,1322200,0,-1322200,-1322200,66200,66200
72674,2,1392600,137300,119500,-17800,-1340000,48400,48400
72674,3,1507600,143200,129200,-14000,-1354000,34400,34400
72674,4,1591900,180000,162400,-17600,-1371600,16800,16800
72675,1,1381800,1381800,0,-1381800,-1381800,6600,6600
72675,2,1426400,105700,107300,1600,-1380200,8200,8200
72675,3,1495400,174300,197100,22800,-1357400,31000,31000
72675,4,1629100,172800,141900,-30900,-1388300,100,100
72676,1,1376400,1376400,0,-1376400,-1376400,12000,12000
72676,2,1384600,222500,247600,25100,-1351300,37100,37100
72676,3,1502000,168700,135400,-33300,-1384600,3800,3800
72676,4,1567500,114300,130500,16200,-1368400,20000,20000
72677,1,1374400,1374400,0,-1374400,-1374400,14000,14000
72677,2,1429300,0,0,0,-1374400,14000,14000
72677,3,1523300,170400,158700,-11700,-1386100,2300,2300
72677,4,1601600,158200,180300,22100,-1364000,24400,24400
72678,1,1381400,1381400,0,-1381400,-1381400,7000,7000
72678,2,1436700,194600,206000,11400,-1370000,18400,18400
72678,3,1570900,143200,132200,-11000,-1381000,7400,7400
72678,4,1663800,108600,128100,19500,-1361500,26900,26900
72679,1,1388400,1388400,0,-1388400,-1388400,0,0
72679,2,1435400,156300,171000,14700,-1373700,14700,14700
72679,3,1554100,156600,142100,-14500,-1388200,200,200
72679,4,1659300,181200,187000,5800,-1382400,6000,6000
72680,1,1384200,1384200,0,-1384200,-1384200,4200,4200
72680,2,1373800,181600,247900,66300,-1317900,70500,70500
72680,3,1539500,193800,142400,-51400,-1369300,19100,19100
72680,4,1678600,150000,146700,-3300,-1372600,15800,15800
72681,1,1370600,1370600,0,-1370600,-1370600,17800,17800
72681,2,1437700,181600,176100,-5500,-1376100,12300,12300
72681,3,1552400,135300,135700,400,-1375700,12700,12700
72681,4,1645200,119600,142700,23100,-1352600,35800,35800
72682,1,1387700,1387700,0,-1387700,-1387700,700,700
72682,2,1414400,128600,130200,1600,-1386100,2300,2300
72682,3,1490000,165500,163600,-1900,-1388000,400,400
72682,4,1578200,196000,196200,200,-1387800,600,600
72684,1,1344800,1344800,0,-1344800,-1344800,43600,43600
72684,2,1388800,206600,207600,1000,-1343800,44600,44600
72684,3,1529000,184400,143200,-41200,-1385000,3400,3400
72684,4,1590400,98800,138400,39600,-1345400,43000,43000
72685,1,1363000,1363000,0,-1363000,-1363000,25400,25400
72685,2,1398700,0,0,0,-1363000,25400,25400
72685,3,1434500,0,0,0,-1363000,25400,25400
72685,4,1462300,0,0,0,-1363000,25400,25400
72687,1,1352800,1352800,0,-1352800,-1352800,35600,35600
72687,2,1413100,0,0,0,-1352800,35600,35600
72687,3,1529300,187200,159900,-27300,-1380100,8300,8300
72687,4,1592800,102600,148000,45400,-1334700,53700,53700
72689,1,1371600,1371600,0,-1371600,-1371600,16800,16800
72689,2,1424200,288800,301400,12600,-1359000,29400,29400
72689,3,1577600,170700,142400,-28300,-1387300,1100,1100
72689,4,1681200,284900,303200,18300,-1369000,19400,19400
72690,1,1327800,1327800,0,-1327800,-1327800,60600,60600
72690,2,1417700,242300,207000,-35300,-1363100,25300,25300
72690,3,1560500,174700,150000,-24700,-1387800,600,600
72690,4,1673300,137000,137300,300,-1387500,900,900
72692,1,1380600,1380600,0,-1380600,-1380600,7800,7800
72692,2,1424700,286800,301000,14200,-1366400,22000,22000
72692,3,1520800,163100,163000,-100,-1366500,21900,21900
72692,4,1631100,189000,187900,-1100,-1367600,20800,20800
72693,1,1384900,1384900,0,-1384900,-1384900,3500,3500
72693,2,1413100,190400,214300,23900,-1361000,27400,27400
72693,3,1535600,138500,112100,-26400,-1387400,1000,1000
72693,4,1634000,225500,229100,3600,-1383800,4600,4600
72695,1,1382700,1382700,0,-1382700,-1382700,5700,5700
72695,2,1416700,0,0,0,-1382700,5700,5700
72695,3,1459500,0,0,0,-1382700,5700,5700
72695,4,1495400,0,0,0,-1382700,5700,5700
72697,1,1388300,1388300,0,-1388300,-1388300,100,100
72697,2,1421100,366700,383200,16500,-1371800,16600,16600
72697,3,1529000,84000,68000,-16000,-1387800,600,600
72697,4,1636600,0,0,0,-1387800,600,600
72699,1,1370500,1370500,0,-1370500,-1370500,17900,17900
72699,2,1407400,366900,380800,13900,-1356600,31800,31800
72699,3,1530200,217000,191100,-25900,-1382500,5900,5900
72699,4,1646600,196300,193000,-3300,-1385800,2600,2600
72701,1,1369900,1369900,0,-1369900,-1369900,18500,18500
72701,2,1417800,226900,225300,-1600,-1371500,16900,16900
72701,3,1502900,168600,158400,-10200,-1381700,6700,6700
72701,4,1605400,139200,140800,1600,-1380100,8300,8300
72702,1,1374300,1374300,0,-1374300,-1374300,14100,14100
72702,2,1414300,218700,220400,1700,-1372600,15800,15800
72702,3,1402100,139300,223200,83900,-1288700,99700,99700
72702,4,1596600,224000,127900,-96100,-1384800,3600,3600
72704,1,1387700,1387700,0,-1387700,-1387700,700,700
72704,2,1403500,210700,210400,-300,-1388000,400,400
72704,3,1427800,78200,78800,600,-1387400,1000,1000
72704,4,1470000,0,0,0,-1387400,1000,1000
72706,1,1369000,1369000,0,-1369000,-1369000,19400,19400
72706,2,1373700,83400,91500,8100,-1360900,27500,27500
72706,3,1396900,0,0,0,-1360900,27500,27500
72706,4,1428300,0,0,0,-1360900,27500,27500
72707,1,1376700,1376700,0,-1376700,-1376700,11700,11700
72707,2,1428900,176000,172000,-4000,-1380700,7700,7700
72707,3,1549300,316400,309200,-7200,-1387900,500,500
72707,4,1671100,297200,306800,9600,-1378300,10100,10100
72708,1,1386700,1386700,0,-1386700,-1386700,1700,1700
72708,2,1422700,0,0,0,-1386700,1700,1700
72708,3,1462200,0,0,0,-1386700,1700,1700
72708,4,1516500,0,0,0,-1386700,1700,1700
72709,1,1386300,1386300,0,-1386300,-1386300,2100,2100
72709,2,1388800,117400,155800,38400,-1347900,40500,40500
72709,3,1499900,219900,203700,-16200,-1364100,24300,24300
72709,4,1640000,230100,208600,-21500,-1385600,2800,2800
72710,1,1388300,1388300,0,-1388300,-1388300,100,100
72710,2,1440300,218900,230800,11900,-1376400,12000,12000
72710,3,1519900,99400,142100,42700,-1333700,54700,54700
72710,4,1669200,198500,147800,-50700,-1384400,4000,4000
72711,1,1386300,1386300,0,-1386300,-1386300,2100,2100
72711,2,1428600,181600,181100,-500,-1386800,1600,1600
72711,3,1519000,242000,240500,-1500,-1388300,100,100
72711,4,1549300,102300,163000,60700,-1327600,60800,60800
72712,1,1375600,1375600,0,-1375600,-1375600,12800,12800
72712,2,1412100,0,0,0,-1375600,12800,12800
72712,3,1476000,0,0,0,-1375600,12800,12800
72712,4,1541900,0,0,0,-1375600,12800,12800
72713,1,1376600,1376600,0,-1376600,-1376600,11800,11800
72713,2,1411800,128800,120000,-8800,-1385400,3000,3000
72713,3,1490900,192000,190100,-1900,-1387300,1100,1100
72713,4,1568600,177800,178600,800,-1386500,1900,1900
72715,1,1385000,1385000,0,-1385000,-1385000,3400,3400
72715,2,1408600,175000,201800,26800,-1358200,30200,30200
72715,3,1515900,252600,248600,-4000,-1362200,26200,26200
72715,4,1632600,134200,110500,-23700,-1385900,2500,2500
72716,1,1384500,1384500,0,-1384500,-1384500,3900,3900
72716,2,1423900,196500,201000,4500,-1380000,8400,8400
72716,3,1480500,99400,136500,37100,-1342900,45500,45500
72716,4,1586800,144700,132700,-12000,-1354900,33500,33500
72719,1,1370800,1370800,0,-1370800,-1370800,17600,17600
72719,2,1440800,110500,95200,-15300,-1386100,2300,2300
72719,3,1529800,252300,267500,15200,-1370900,17500,17500
72719,4,1631500,0,0,0,-1370900,17500,17500
72720,1,1383100,1383100,0,-1383100,-1383100,5300,5300
72720,2,1396400,181600,210500,28900,-1354200,34200,34200
72720,3,1542800,173400,142400,-31000,-1385200,3200,3200
72720,4,1662300,204400,207900,3500,-1381700,6700,6700
72722,1,1382300,1382300,0,-1382300,-1382300,6100,6100
72722,2,1440500,216500,218300,1800,-1380500,7900,7900
72722,3,1532200,128800,142400,13600,-1366900,21500,21500
72722,4,1657700,221700,214300,-7400,-1374300,14100,14100
72723,1,1384400,1384400,0,-1384400,-1384400,4000,4000
72723,2,1452200,218900,225700,6800,-1377600,10800,10800
72723,3,1556400,167900,181400,13500,-1364100,24300,24300
72723,4,1651600,230800,258100,27300,-1336800,51600,51600
72724,1,1369500,1369500,0,-1369500,-1369500,18900,18900
72724,2,1407400,0,0,0,-1369500,18900,18900
72724,3,1487300,150200,134400,-15800,-1385300,3100,3100
72724,4,1560300,0,0,0,-1385300,3100,3100
72725,1,1384100,1384100,0,-1384100,-1384100,4300,4300
72725,2,1426700,187600,204800,17200,-1366900,21500,21500
72725,3,1556800,117500,96100,-21400,-1388300,100,100
72725,4,1665700,235200,238000,2800,-1385500,2900,2900
72726,1,1387700,1387700,0,-1387700,-1387700,700,700
72726,2,1382400,94100,106300,12200,-1375500,12900,12900
72726,3,1423900,164800,176100,11300,-1364200,24200,24200
72726,4,1502900,138500,118300,-20200,-1384400,4000,4000
72727,1,1378700,1378700,0,-1378700,-1378700,9700,9700
72727,2,1411200,0,0,0,-1378700,9700,9700
72727,3,1453400,0,0,0,-1378700,9700,9700
72727,4,1508400,0,0,0,-1378700,9700,9700
72729,1,1386100,1386100,0,-1386100,-1386100,2300,2300
72729,2,1391600,67800,78100,10300,-1375800,12600,12600
72729,3,1438500,194100,186900,-7200,-1383000,5400,5400
72729,4,1496900,0,0,0,-1383000,5400,5400
72731,1,1376600,1376600,0,-1376600,-1376600,11800,11800
72731,2,1401500,175100,204400,29300,-1347300,41100,41100
72731,3,1512600,158300,142100,-16200,-1363500,24900,24900
72731,4,1626400,194600,176600,-18000,-1381500,6900,6900
72733,1,1387200,1387200,0,-1387200,-1387200,1200,1200
72733,2,1408200,96800,95800,-1000,-1388200,200,200
72733,3,1464800,140400,147500,7100,-1381100,7300,7300
72733,4,1492300,182000,182600,600,-1380500,7900,7900
72734,1,1388000,1388000,0,-1388000,-1388000,400,400
72734,2,1453500,107100,107300,200,-1387800,600,600
72734,3,1548100,149800,150800,1000,-1386800,1600,1600
72734,4,1650900,122000,125000,3000,-1383800,4600,4600
72735,1,1388000,1388000,0,-1388000,-1388000,400,400
72735,2,1401900,226600,264000,37400,-1350600,37800,37800
72735,3,1520700,222100,204500,-17600,-1368200,20200,20200
72735,4,1669300,181400,164100,-17300,-1385500,2900,2900
72736,1,1368700,1368700,0,-1368700,-1368700,19700,19700
72736,2,1433800,280700,265100,-15600,-1384300,4100,4100
72736,3,1539700,280900,279300,-1600,-1385900,2500,2500
72736,4,1679600,222000,221800,-200,-1386100,2300,2300
72737,1,1384200,1384200,0,-1384200,-1384200,4200,4200
72737,2,1426100,174200,183000,8800,-1375400,13000,13000
72737,3,1553100,168000,161700,-6300,-1381700,6700,6700
72737,4,1677400,158200,153100,-5100,-1386800,1600,1600
72738,1,1367600,1367600,0,-1367600,-1367600,20800,20800
72738,2,1426800,176000,167300,-8700,-1376300,12100,12100
72738,3,1527600,176100,171000,-5100,-1381400,7000,7000
72738,4,1523700,142000,263600,121600,-1259800,128600,128600
72739,1,1385400,1385400,0,-1385400,-1385400,3000,3000
72739,2,1363200,114400,151200,36800,-1348600,39800,39800
72739,3,1457500,120200,88000,-32200,-1380800,7600,7600
72739,4,1497500,230700,230500,-200,-1381000,7400,7400
72740,1,1387700,1387700,0,-1387700,-1387700,700,700
72740,2,1441300,167800,167900,100,-1387600,800,800
72740,3,1524200,184200,196300,12100,-1375500,12900,12900
72740,4,1638100,153400,150800,-2600,-1378100,10300,10300
72744,1,1386500,1386500,0,-1386500,-1386500,1900,1900
72744,2,1413700,0,0,0,-1386500,1900,1900
72744,3,1460100,0,0,0,-1386500,1900,1900
72744,4,1520200,0,0,0,-1386500,1900,1900
72745,1,1382700,1382700,0,-1382700,-1382700,5700,5700
72745,2,1448200,116100,110600,-5500,-1388200,200,200
72745,3,1554800,206900,213100,6200,-1382000,6400,6400
72745,4,1676800,157000,150700,-6300,-1388300,100,100
72746,1,1374700,1374700,0,-1374700,-1374700,13700,13700
72746,2,1444400,110400,97000,-13400,-1388100,300,300
72746,3,1541600,140200,142100,1900,-1386200,2200,2200
72746,4,1590300,93400,131200,37800,-1348400,40000,40000
72750,1,1386000,1386000,0,-1386000,-1386000,2400,2400
72750,2,1405600,179900,199900,20000,-1366000,22400,22400
72750,3,1502900,155300,136600,-18700,-1384700,3700,3700
72750,4,1573100,212800,224000,11200,-1373500,14900,14900
72751,1,1358100,1358100,0,-1358100,-1358100,30300,30300
72751,2,1389100,117500,136700,19200,-1338900,49500,49500
72751,3,1543200,210700,166500,-44200,-1383100,5300,5300
72751,4,1656300,71000,82300,11300,-1371800,16600,16600
72752,1,1366300,1366300,0,-1366300,-1366300,22100,22100
72752,2,1419300,181600,184600,3000,-1363300,25100,25100
72752,3,1555600,202200,180700,-21500,-1384800,3600,3600
72752,4,1667400,218100,224000,5900,-1378900,9500,9500
72756,1,1383700,1383700,0,-1383700,-1383700,4700,4700
72756,2,1413100,0,0,0,-1383700,4700,4700
72756,3,1445500,0,0,0,-1383700,4700,4700
72756,4,1481600,0,0,0,-1383700,4700,4700
72757,1,1380000,1380000,0,-1380000,-1380000,8400,8400
72757,2,1432800,0,0,0,-1380000,8400,8400
72757,3,1520600,0,0,0,-1380000,8400,8400
72757,4,1577600,0,0,0,-1380000,8400,8400
72758,1,1319800,1319800,0,-1319800,-1319800,68600,68600
72758,2,1420700,192800,141800,-51000,-1370800,17600,17600
72758,3,1522400,161300,161700,400,-1370400,18000,18000
72758,4,1630600,259700,247400,-12300,-1382700,5700,5700
72760,1,1385500,1385500,0,-1385500,-1385500,2900,2900
72760,2,1392400,301000,330400,29400,-1356100,32300,32300
72760,3,1498600,135400,104800,-30600,-1386700,1700,1700
72760,4,1567000,114000,132300,18300,-1368400,20000,20000
72761,1,1374900,1374900,0,-1374900,-1374900,13500,13500
72761,2,1384900,0,0,0,-1374900,13500,13500
72761,3,1387100,0,0,0,-1374900,13500,13500
72761,4,1417600,0,0,0,-1374900,13500,13500
72762,1,1382900,1382900,0,-1382900,-1382900,5500,5500
72762,2,1448200,164600,159100,-5500,-1388400,0,0
72762,3,1520000,198300,203700,5400,-1383000,5400,5400
72762,4,1603400,170600,167100,-3500,-1386500,1900,1900
72763,1,1348800,1348800,0,-1348800,-1348800,39600,39600
72763,2,1389800,0,0,0,-1348800,39600,39600
72763,3,1457000,0,0,0,-1348800,39600,39600
72763,4,1530300,0,0,0,-1348800,39600,39600
72765,1,1386300,1386300,0,-1386300,-1386300,2100,2100
72765,2,1429300,0,0,0,-1386300,2100,2100
72765,3,1506400,0,0,0,-1386300,2100,2100
72765,4,1576700,0,0,0,-1386300,2100,2100
72767,1,1388300,1388300,0,-1388300,-1388300,100,100
72767,2,1423600,170800,179300,8500,-1379800,8600,8600
72767,3,1509700,136700,134300,-2400,-1382200,6200,6200
72767,4,1575200,0,0,0,-1382200,6200,6200
72768,1,1384000,1384000,0,-1384000,-1384000,4400,4400
72768,2,1439500,174200,171200,-3000,-1387000,1400,1400
72768,3,1492800,104200,135400,31200,-1355800,32600,32600
72768,4,1599100,140400,126400,-14000,-1369800,18600,18600
72770,1,1388100,1388100,0,-1388100,-1388100,300,300
72770,2,1446100,203200,206900,3700,-1384400,4000,4000
72770,3,1565600,166900,163700,-3200,-1387600,800,800
72770,4,1696300,196900,196100,-800,-1388400,0,0
72771,1,1387400,1387400,0,-1387400,-1387400,1000,1000
72771,2,1399400,0,0,0,-1387400,1000,1000
72771,3,1424700,0,0,0,-1387400,1000,1000
72771,4,1446400,0,0,0,-1387400,1000,1000
72774,1,1387600,1387600,0,-1387600,-1387600,800,800
72774,2,1393800,0,0,0,-1387600,800,800
72774,3,1391100,0,0,0,-1387600,800,800
72774,4,1367000,0,0,0,-1387600,800,800
72775,1,1387700,1387700,0,-1387700,-1387700,700,700
72775,2,1424100,219500,237400,17900,-1369800,18600,18600
72775,3,1558400,173600,160900,-12700,-1382500,5900,5900
72775,4,1658800,178900,213100,34200,-1348300,40100,40100
72777,1,1356000,1356000,0,-1356000,-1356000,32400,32400
72777,2,1365900,264900,288100,23200,-1332800,55600,55600
72777,3,1498500,255600,200200,-55400,-1388200,200,200
72777,4,1597100,207300,207600,300,-1387900,500,500
72778,1,1231700,1231700,0,-1231700,-1231700,156700,156700
72778,2,1417400,278800,141800,-137000,-1368700,19700,19700
72778,3,1540400,187100,177300,-9800,-1378500,9900,9900
72778,4,1652700,0,0,0,-1378500,9900,9900
72779,1,1385800,1385800,0,-1385800,-1385800,2600,2600
72779,2,1426600,176900,188900,12000,-1373800,14600,14600
72779,3,1537100,148100,139400,-8700,-1382500,5900,5900
72779,4,1641700,205700,220000,14300,-1368200,20200,20200
72782,1,1375200,1375200,0,-1375200,-1375200,13200,13200
72782,2,1425200,0,0,0,-1375200,13200,13200
72782,3,1504700,0,0,0,-1375200,13200,13200
72782,4,1585300,0,0,0,-1375200,13200,13200
72783,1,1352800,1352800,0,-1352800,-1352800,35600,35600
72783,2,1452300,126900,94000,-32900,-1385700,2700,2700
72783,3,1552600,178900,199400,20500,-1365200,23200,23200
72783,4,1659800,119700,137300,17600,-1347600,40800,40800
72785,1,1339300,1339300,0,-1339300,-1339300,49100,49100
72785,2,1402700,226600,210100,-16500,-1355800,32600,32600
72785,3,1512600,0,0,0,-1355800,32600,32600
72785,4,1625400,316500,308100,-8400,-1364200,24200,24200
72786,1,1381900,1381900,0,-1381900,-1381900,6500,6500
72786,2,1391500,110900,135500,24600,-1357300,31100,31100
72786,3,1491500,172100,141800,-30300,-1387600,800,800
72786,4,1563200,175000,181700,6700,-1380900,7500,7500
72787,1,1380500,1380500,0,-1380500,-1380500,7900,7900
72787,2,1376500,181700,218400,36700,-1343800,44600,44600
72787,3,1504700,244500,213700,-30800,-1374600,13800,13800
72787,4,1639200,280400,278600,-1800,-1376400,12000,12000
72788,1,1386700,1386700,0,-1386700,-1386700,1700,1700
72788,2,1387300,58600,60600,2000,-1384700,3700,3700
72788,3,1401000,0,0,0,-1384700,3700,3700
72788,4,1423900,0,0,0,-1384700,3700,3700
72789,1,1382900,1382900,0,-1382900,-1382900,5500,5500
72789,2,1432200,223400,232500,9100,-1373800,14600,14600
72789,3,1563300,161700,150000,-11700,-1385500,2900,2900
72789,4,1684600,185800,192900,7100,-1378400,10000,10000
72790,1,1387800,1387800,0,-1387800,-1387800,600,600
72790,2,1440100,132700,139800,7100,-1380700,7700,7700
72790,3,1547200,0,0,0,-1380700,7700,7700
72790,4,1657600,308600,306300,-2300,-1383000,5400,5400
72791,1,1386200,1386200,0,-1386200,-1386200,2200,2200
72791,2,1438600,255900,264200,8300,-1377900,10500,10500
72791,3,1555500,149800,142400,-7400,-1385300,3100,3100
72791,4,1673400,175800,176400,600,-1384700,3700,3700
72792,1,1371700,1371700,0,-1371700,-1371700,16700,16700
72792,2,1381400,241500,270500,29000,-1342700,45700,45700
72792,3,1520600,196000,154400,-41600,-1384300,4100,4100
72792,4,1640100,0,0,0,-1384300,4100,4100
72793,1,1385000,1385000,0,-1385000,-1385000,3400,3400
72793,2,1428700,362000,362000,0,-1385000,3400,3400
72793,3,1520200,168900,166800,-2100,-1387100,1300,1300
72793,4,1610300,0,0,0,-1387100,1300,1300
72794,1,1385300,1385300,0,-1385300,-1385300,3100,3100
72794,2,1445400,191200,188700,-2500,-1387800,600,600
72794,3,1553400,151700,162100,10400,-1377400,11000,11000
72794,4,1684400,135000,131200,-3800,-1381200,7200,7200
72800,1,1335300,1335300,0,-1335300,-1335300,53100,53100
72800,2,1341300,0,0,0,-1335300,53100,53100
72800,3,1344500,0,0,0,-1335300,53100,53100
72800,4,1348600,0,0,0,-1335300,53100,53100
72801,1,1386600,1386600,0,-1386600,-1386600,1800,1800
72801,2,1435400,304400,311500,7100,-1379500,8900,8900
72801,3,1541400,201700,196000,-5700,-1385200,3200,3200
72801,4,1657700,0,0,0,-1385200,3200,3200
72802,1,1373000,1373000,0,-1373000,-1373000,15400,15400
72802,2,1424200,349700,346200,-3500,-1376500,11900,11900
72802,3,1541900,363900,355400,-8500,-1385000,3400,3400
72802,4,1636900,181500,189300,7800,-1377200,11200,11200
72805,1,1321700,1321700,0,-1321700,-1321700,66700,66700
72805,2,1378500,241500,215500,-26000,-1347700,40700,40700
72805,3,1482700,164700,143200,-21500,-1369200,19200,19200
72805,4,1539000,168000,206600,38600,-1330600,57800,57800
72807,1,1376000,1376000,0,-1376000,-1376000,12400,12400
72807,2,1449400,137300,126900,-10400,-1386400,2000,2000
72807,3,1552900,112400,125500,13100,-1373300,15100,15100
72807,4,1666300,168000,153100,-14900,-1388200,200,200
72808,1,1387200,1387200,0,-1387200,-1387200,1200,1200
72808,2,1453100,132500,143100,10600,-1376600,11800,11800
72808,3,1564800,193700,191400,-2300,-1378900,9500,9500
72808,4,1649000,134900,150800,15900,-1363000,25400,25400
72810,1,1387900,1387900,0,-1387900,-1387900,500,500
72810,2,1376000,167700,213200,45500,-1342400,46000,46000
72810,3,1518200,255600,213900,-41700,-1384100,4300,4300
72810,4,1641900,126500,133400,6900,-1377200,11200,11200
72811,1,1388000,1388000,0,-1388000,-1388000,400,400
72811,2,1400400,173900,173800,-100,-1388100,300,300
72811,3,1448300,238400,242500,4100,-1384000,4400,4400
72811,4,1518900,161000,160400,-600,-1384600,3800,3800
72814,1,1384300,1384300,0,-1384300,-1384300,4100,4100
72814,2,1420400,187100,193900,6800,-1377500,10900,10900
72814,3,1507600,135200,142500,7300,-1370200,18200,18200
72814,4,1624000,197500,179900,-17600,-1387800,600,600
72816,1,1388100,1388100,0,-1388100,-1388100,300,300
72816,2,1397900,0,0,0,-1388100,300,300
72816,3,1415500,0,0,0,-1388100,300,300
72816,4,1446400,0,0,0,-1388100,300,300
72817,1,1367200,1367200,0,-1367200,-1367200,21200,21200
72817,2,1383600,0,0,0,-1367200,21200,21200
72817,3,1425300,0,0,0,-1367200,21200,21200
72817,4,1460000,0,0,0,-1367200,21200,21200
72819,1,1386700,1386700,0,-1386700,-1386700,1700,1700
72819,2,1397700,0,0,0,-1386700,1700,1700
72819,3,1420000,0,0,0,-1386700,1700,1700
72819,4,1439800,0,0,0,-1386700,1700,1700
72820,1,1382900,1382900,0,-1382900,-1382900,5500,5500
72820,2,1424200,0,0,0,-1382900,5500,5500
72820,3,1499500,0,0,0,-1382900,5500,5500
72820,4,1573000,0,0,0,-1382900,5500,5500
72824,1,1362400,1362400,0,-1362400,-1362400,26000,26000
72824,2,1448300,297300,271600,-25700,-1388100,300,300
72824,3,1548600,175300,187700,12400,-1375700,12700,12700
72824,4,1686600,145300,132700,-12600,-1388300,100,100
72825,1,1385100,1385100,0,-1385100,-1385100,3300,3300
72825,2,1443600,159000,162200,3200,-1381900,6500,6500
72825,3,1541000,0,0,0,-1381900,6500,6500
72825,4,1632200,176100,173000,-3100,-1385000,3400,3400
72826,1,1293400,1293400,0,-1293400,-1293400,95000,95000
72826,2,1414700,240700,179000,-61700,-1355100,33300,33300
72826,3,1538000,219200,196900,-22300,-1377400,11000,11000
72826,4,1652000,0,0,0,-1377400,11000,11000
72828,1,1367600,1367600,0,-1367600,-1367600,20800,20800
72828,2,1385600,144600,138500,-6100,-1373700,14700,14700
72828,3,1413900,167400,163400,-4000,-1377700,10700,10700
72828,4,1449700,140600,141300,700,-1377000,11400,11400
72829,1,1372400,1372400,0,-1372400,-1372400,16000,16000
72829,2,1421800,255300,271200,15900,-1356500,31900,31900
72829,3,1520800,0,0,0,-1356500,31900,31900
72829,4,1621100,0,0,0,-1356500,31900,31900
72831,1,1266200,1266200,0,-1266200,-1266200,122200,122200
72831,2,1364600,179000,138400,-40600,-1306800,81600,81600
72831,3,1571400,219700,139400,-80300,-1387100,1300,1300
72831,4,1688700,133900,135600,1700,-1385400,3000,3000
72832,1,1373800,1373800,0,-1373800,-1373800,14600,14600
72832,2,1436100,0,0,0,-1373800,14600,14600
72832,3,1523600,0,0,0,-1373800,14600,14600
72832,4,1627100,0,0,0,-1373800,14600,14600
72833,1,1374700,1374700,0,-1374700,-1374700,13700,13700
72833,2,1408900,243200,237300,-5900,-1380600,7800,7800
72833,3,1488300,266000,260600,-5400,-1386000,2400,2400
72833,4,1549100,224800,245800,21000,-1365000,23400,23400
72835,1,1363900,1363900,0,-1363900,-1363900,24500,24500
72835,2,1392800,0,0,0,-1363900,24500,24500
72835,3,1443000,0,0,0,-1363900,24500,24500
72835,4,1507200,0,0,0,-1363900,24500,24500
72837,1,1377700,1377700,0,-1377700,-1377700,10700,10700
72837,2,1426200,302300,310200,7900,-1369800,18600,18600
72837,3,1561900,165300,147300,-18000,-1387800,600,600
72837,4,1666700,272500,276800,4300,-1383500,4900,4900
72838,1,1383200,1383200,0,-1383200,-1383200,5200,5200
72838,2,1406900,158100,155100,-3000,-1386200,2200,2200
72838,3,1480500,0,0,0,-1386200,2200,2200
72838,4,1523000,0,0,0,-1386200,2200,2200
72839,1,1370900,1370900,0,-1370900,-1370900,17500,17500
72839,2,1418800,219700,208000,-11700,-1382600,5800,5800
72839,3,1500000,0,0,0,-1382600,5800,5800
72839,4,1587300,0,0,0,-1382600,5800,5800
72840,1,1385700,1385700,0,-1385700,-1385700,2700,2700
72840,2,1387800,178200,190100,11900,-1373800,14600,14600
72840,3,1447500,196300,182900,-13400,-1387200,1200,1200
72840,4,1520300,175900,179000,3100,-1384100,4300,4300
72841,1,1388200,1388200,0,-1388200,-1388200,200,200
72841,2,1408400,127000,149700,22700,-1365500,22900,22900
72841,3,1501800,157200,142100,-15100,-1380600,7800,7800
72841,4,1569100,142100,166800,24700,-1355900,32500,32500
72842,1,1386500,1386500,0,-1386500,-1386500,1900,1900
72842,2,1444500,216900,216700,-200,-1386700,1700,1700
72842,3,1544400,215300,217500,2200,-1384500,3900,3900
72842,4,1678200,176200,174800,-1400,-1385900,2500,2500
72843,1,1386600,1386600,0,-1386600,-1386600,1800,1800
72843,2,1446700,228100,226500,-1600,-1388200,200,200
72843,3,1533300,262300,265000,2700,-1385500,2900,2900
72843,4,1612900,152800,150000,-2800,-1388300,100,100
72844,1,1383000,1383000,0,-1383000,-1383000,5400,5400
72844,2,1428100,0,0,0,-1383000,5400,5400
72844,3,1490400,0,0,0,-1383000,5400,5400
72844,4,1568000,0,0,0,-1383000,5400,5400
72846,1,1370500,1370500,0,-1370500,-1370500,17900,17900
72846,2,1427800,0,0,0,-1370500,17900,17900
72846,3,1516100,61200,69100,7900,-1362600,25800,25800
72846,4,1595100,135300,155000,19700,-1342900,45500,45500
72847,1,1387900,1387900,0,-1387900,-1387900,500,500
72847,2,1451600,194400,196100,1700,-1386200,2200,2200
72847,3,1574200,173500,179800,6300,-1379900,8500,8500
72847,4,1706700,210600,207400,-3200,-1383100,5300,5300
72848,1,1370200,1370200,0,-1370200,-1370200,18200,18200
72848,2,1408200,156700,171100,14400,-1355800,32600,32600
72848,3,1518700,0,0,0,-1355800,32600,32600
72848,4,1624700,0,0,0,-1355800,32600,32600
72850,1,1376100,1376100,0,-1376100,-1376100,12300,12300
72850,2,1440200,133800,134700,900,-1375200,13200,13200
72850,3,1549200,206900,213100,6200,-1369000,19400,19400
72850,4,1671600,235800,229700,-6100,-1375100,13300,13300
72852,1,1388400,1388400,0,-1388400,-1388400,0,0
72852,2,1437600,199400,199400,0,-1388400,0,0
72852,3,1517400,165600,166500,900,-1387500,900,900
72852,4,1602600,155700,156500,800,-1386700,1700,1700
72854,1,1377200,1377200,0,-1377200,-1377200,11200,11200
72854,2,1395700,80300,105300,25000,-1352200,36200,36200
72854,3,1507500,214200,201000,-13200,-1365400,23000,23000
72854,4,1605100,0,0,0,-1365400,23000,23000
72855,1,1374400,1374400,0,-1374400,-1374400,14000,14000
72855,2,1411900,0,0,0,-1374400,14000,14000
72855,3,1489800,0,0,0,-1374400,14000,14000
72855,4,1558700,0,0,0,-1374400,14000,14000
72857,1,1387600,1387600,0,-1387600,-1387600,800,800
72857,2,1412800,142700,157900,15200,-1372400,16000,16000
72857,3,1490100,115100,113700,-1400,-1373800,14600,14600
72857,4,1556600,78800,91300,12500,-1361300,27100,27100
72859,1,1374000,1374000,0,-1374000,-1374000,14400,14400
72859,2,1421300,235400,241300,5900,-1368100,20300,20300
72859,3,1559900,191400,178100,-13300,-1381400,7000,7000
72859,4,1658500,224900,250400,25500,-1355900,32500,32500
72861,1,1375600,1375600,0,-1375600,-1375600,12800,12800
72861,2,1420100,0,0,0,-1375600,12800,12800
72861,3,1493000,138700,140700,2000,-1373600,14800,14800
72861,4,1581400,0,0,0,-1373600,14800,14800
72862,1,1386300,1386300,0,-1386300,-1386300,2100,2100
72862,2,1416400,119200,117200,-2000,-1388300,100,100
72862,3,1484900,161800,168100,6300,-1382000,6400,6400
72862,4,1569000,75400,69900,-5500,-1387500,900,900
72869,1,1378900,1378900,0,-1378900,-1378900,9500,9500
72869,2,1414500,179000,207600,28600,-1350300,38100,38100
72869,3,1541600,143200,142400,-800,-1351100,37300,37300
72869,4,1682400,171700,156800,-14900,-1366000,22400,22400
72872,1,1383400,1383400,0,-1383400,-1383400,5000,5000
72872,2,1383800,224300,257400,33100,-1350300,38100,38100
72872,3,1534600,302300,269200,-33100,-1383400,5000,5000
72872,4,1663700,164700,172700,8000,-1375400,13000,13000
72873,1,1377900,1377900,0,-1377900,-1377900,10500,10500
72873,2,1440000,234200,235800,1600,-1376300,12100,12100
72873,3,1552800,279500,270500,-9000,-1385300,3100,3100
72873,4,1656700,189200,190100,900,-1384400,4000,4000
72875,1,1365900,1365900,0,-1365900,-1365900,22500,22500
72875,2,1444600,278500,256200,-22300,-1388200,200,200
72875,3,1524800,185900,191600,5700,-1382500,5900,5900
72875,4,1606900,294000,296400,2400,-1380100,8300,8300
72878,1,1352800,1352800,0,-1352800,-1352800,35600,35600
72878,2,1417400,0,0,0,-1352800,35600,35600
72878,3,1545000,167900,139400,-28500,-1381300,7100,7100
72878,4,1659700,0,0,0,-1381300,7100,7100
72879,1,1384500,1384500,0,-1384500,-1384500,3900,3900
72879,2,1404800,110700,112100,1400,-1383100,5300,5300
72879,3,1455100,0,0,0,-1383100,5300,5300
72879,4,1523800,0,0,0,-1383100,5300,5300
72880,1,1365400,1365400,0,-1365400,-1365400,23000,23000
72880,2,1429700,231300,209400,-21900,-1387300,1100,1100
72880,3,1508000,158300,172000,13700,-1373600,14800,14800
72880,4,1632300,129400,125200,-4200,-1377800,10600,10600
72881,1,1388200,1388200,0,-1388200,-1388200,200,200
72881,2,1334400,230700,307900,77200,-1311000,77400,77400
72881,3,1474600,257500,186200,-71300,-1382300,6100,6100
72881,4,1514200,218200,240100,21900,-1360400,28000,28000
72882,1,1375100,1375100,0,-1375100,-1375100,13300,13300
72882,2,1448200,80300,68200,-12100,-1387200,1200,1200
72882,3,1578500,144100,143600,-500,-1387700,700,700
72882,4,1687300,205100,213600,8500,-1379200,9200,9200
72883,1,1385900,1385900,0,-1385900,-1385900,2500,2500
72883,2,1433300,175000,187000,12000,-1373900,14500,14500
72883,3,1533700,220800,230200,9400,-1364500,23900,23900
72883,4,1650100,154900,146300,-8600,-1373100,15300,15300
72884,1,1386300,1386300,0,-1386300,-1386300,2100,2100
72884,2,1403100,113500,141200,27700,-1358600,29800,29800
72884,3,1519400,171000,142400,-28600,-1387200,1200,1200
72884,4,1599900,198700,216900,18200,-1369000,19400,19400
72885,1,1387900,1387900,0,-1387900,-1387900,500,500
72885,2,1421000,0,0,0,-1387900,500,500
72885,3,1462600,0,0,0,-1387900,500,500
72885,4,1487900,0,0,0,-1387900,500,500
72887,1,1347700,1347700,0,-1347700,-1347700,40700,40700
72887,2,1437000,206600,178500,-28100,-1375800,12600,12600
72887,3,1518200,145300,177900,32600,-1343200,45200,45200
72887,4,1649000,249100,232600,-16500,-1359700,28700,28700
72889,1,1369400,1369400,0,-1369400,-1369400,19000,19000
72889,2,1430600,110500,96100,-14400,-1383800,4600,4600
72889,3,1512900,202000,213100,11100,-1372700,15700,15700
72889,4,1630800,143600,131000,-12600,-1385300,3100,3100
72890,1,1346500,1346500,0,-1346500,-1346500,41900,41900
72890,2,1390300,0,0,0,-1346500,41900,41900
72890,3,1467300,0,0,0,-1346500,41900,41900
72890,4,1548300,0,0,0,-1346500,41900,41900
72891,1,1376500,1376500,0,-1376500,-1376500,11900,11900
72891,2,1425600,113500,127600,14100,-1362400,26000,26000
72891,3,1534100,70700,73700,3000,-1359400,29000,29000
72891,4,1682100,250500,221500,-29000,-1388400,0,0
72892,1,1384500,1384500,0,-1384500,-1384500,3900,3900
72892,2,1391000,0,0,0,-1384500,3900,3900
72892,3,1394500,0,0,0,-1384500,3900,3900
72892,4,1393700,0,0,0,-1384500,3900,3900
72893,1,1381600,1381600,0,-1381600,-1381600,6800,6800
72893,2,1409000,174300,200600,26300,-1355300,33100,33100
72893,3,1516500,112400,118500,6100,-1349200,39200,39200
72893,4,1629400,181100,185500,4400,-1344800,43600,43600
72894,1,1380200,1380200,0,-1380200,-1380200,8200,8200
72894,2,1401700,243200,270800,27600,-1352600,35800,35800
72894,3,1542200,276800,245800,-31000,-1383600,4800,4800
72894,4,1672300,220800,226100,5300,-1378300,10100,10100
72895,1,1377000,1377000,0,-1377000,-1377000,11400,11400
72895,2,1417800,0,0,0,-1377000,11400,11400
72895,3,1521400,0,0,0,-1377000,11400,11400
72895,4,1624300,0,0,0,-1377000,11400,11400
72896,1,1384200,1384200,0,-1384200,-1384200,4200,4200
72896,2,1435700,256600,261900,5300,-1378900,9500,9500
72896,3,1544000,215300,217500,2200,-1376700,11700,11700
72896,4,1676800,217200,209400,-7800,-1384500,3900,3900
72897,1,1386800,1386800,0,-1386800,-1386800,1600,1600
72897,2,1430700,261600,271200,9600,-1377200,11200,11200
72897,3,1522600,0,0,0,-1377200,11200,11200
72897,4,1595500,0,0,0,-1377200,11200,11200
72900,1,1377100,1377100,0,-1377100,-1377100,11300,11300
72900,2,1450000,174300,174300,0,-1377100,11300,11300
72900,3,1568300,332300,326300,-6000,-1383100,5300,5300
72900,4,1701500,249400,256300,6900,-1376200,12200,12200
72901,1,1370300,1370300,0,-1370300,-1370300,18100,18100
72901,2,1385600,168200,188600,20400,-1349900,38500,38500
72901,3,1456900,0,0,0,-1349900,38500,38500
72901,4,1532700,0,0,0,-1349900,38500,38500
72902,1,1370600,1370600,0,-1370600,-1370600,17800,17800
72902,2,1410900,208900,228200,19300,-1351300,37100,37100
72902,3,1560300,173100,142400,-30700,-1382000,6400,6400
72902,4,1657900,104700,139200,34500,-1347500,40900,40900
72904,1,1366200,1366200,0,-1366200,-1366200,22200,22200
72904,2,1431800,0,0,0,-1366200,22200,22200
72904,3,1532200,0,0,0,-1366200,22200,22200
72904,4,1623500,0,0,0,-1366200,22200,22200
72905,1,1386300,1386300,0,-1386300,-1386300,2100,2100
72905,2,1432000,193200,197300,4100,-1382200,6200,6200
72905,3,1535500,168700,175700,7000,-1375200,13200,13200
72905,4,1656700,276200,265300,-10900,-1386100,2300,2300
72906,1,1373300,1373300,0,-1373300,-1373300,15100,15100
72906,2,1405100,227300,214900,-12400,-1385700,2700,2700
72906,3,1484500,0,0,0,-1385700,2700,2700
72906,4,1571300,142700,141300,-1400,-1387100,1300,1300
72907,1,1387800,1387800,0,-1387800,-1387800,600,600
72907,2,1420700,170800,171500,700,-1387100,1300,1300
72907,3,1505000,0,0,0,-1387100,1300,1300
72907,4,1591200,0,0,0,-1387100,1300,1300
72909,1,1246100,1246100,0,-1246100,-1246100,142300,142300
72909,2,1375500,199700,136400,-63300,-1309400,79000,79000
72909,3,1523900,180800,142100,-38700,-1348100,40300,40300
72909,4,1668900,227100,201900,-25200,-1373300,15100,15100
72911,1,1350300,1350300,0,-1350300,-1350300,38100,38100
72911,2,1325000,253200,311100,57900,-1292400,96000,96000
72911,3,1509200,238000,142100,-95900,-1388300,100,100
72911,4,1599600,221400,234500,13100,-1375200,13200,13200
72913,1,1386500,1386500,0,-1386500,-1386500,1900,1900
72913,2,1456900,0,0,0,-1386500,1900,1900
72913,3,1553300,250600,258300,7700,-1378800,9600,9600
72913,4,1672100,147800,144500,-3300,-1382100,6300,6300
72914,1,1388200,1388200,0,-1388200,-1388200,200,200
72914,2,1429500,159100,167300,8200,-1380000,8400,8400
72914,3,1516800,221400,217200,-4200,-1384200,4200,4200
72914,4,1602500,254100,283100,29000,-1355200,33200,33200
72916,1,1386700,1386700,0,-1386700,-1386700,1700,1700
72916,2,1445900,302300,301200,-1100,-1387800,600,600
72916,3,1546900,203100,203700,600,-1387200,1200,1200
72916,4,1642800,240500,248500,8000,-1379200,9200,9200
72917,1,1366800,1366800,0,-1366800,-1366800,21600,21600
72917,2,1445200,181600,162700,-18900,-1385700,2700,2700
72917,3,1569100,213000,213100,100,-1385600,2800,2800
72917,4,1703300,254200,256800,2600,-1383000,5400,5400
72919,1,1387400,1387400,0,-1387400,-1387400,1000,1000
72919,2,1410400,230100,234700,4600,-1382800,5600,5600
72919,3,1463900,149000,148700,-300,-1383100,5300,5300
72919,4,1513400,197400,197700,300,-1382800,5600,5600
72920,1,1380600,1380600,0,-1380600,-1380600,7800,7800
72920,2,1442600,185100,182900,-2200,-1382800,5600,5600
72920,3,1546800,181700,182500,800,-1382000,6400,6400
72920,4,1662400,187300,183700,-3600,-1385600,2800,2800
72921,1,1387500,1387500,0,-1387500,-1387500,900,900
72921,2,1438800,0,0,0,-1387500,900,900
72921,3,1517000,0,0,0,-1387500,900,900
72921,4,1583100,0,0,0,-1387500,900,900
72922,1,1380200,1380200,0,-1380200,-1380200,8200,8200
72922,2,1398900,113100,141800,28700,-1351500,36900,36900
72922,3,1542600,176100,142100,-34000,-1385500,2900,2900
72922,4,1656700,0,0,0,-1385500,2900,2900
72923,1,1387900,1387900,0,-1387900,-1387900,500,500
72923,2,1394300,0,0,0,-1387900,500,500
72923,3,1407000,0,0,0,-1387900,500,500
72923,4,1425900,0,0,0,-1387900,500,500
72925,1,1378200,1378200,0,-1378200,-1378200,10200,10200
72925,2,1415600,0,0,0,-1378200,10200,10200
72925,3,1486500,145400,135700,-9700,-1387900,500,500
72925,4,1551200,191500,198800,7300,-1380600,7800,7800
72927,1,1387100,1387100,0,-1387100,-1387100,1300,1300
72927,2,1406500,0,0,0,-1387100,1300,1300
72927,3,1442800,0,0,0,-1387100,1300,1300
72927,4,1468000,0,0,0,-1387100,1300,1300
72928,1,1381100,1381100,0,-1381100,-1381100,7300,7300
72928,2,1417300,199400,193000,-6400,-1387500,900,900
72928,3,1485600,222100,221800,-300,-1387800,600,600
72928,4,1569900,203100,203400,300,-1387500,900,900
72929,1,1381600,1381600,0,-1381600,-1381600,6800,6800
72929,2,1431300,127900,140600,12700,-1368900,19500,19500
72929,3,1528600,149800,142400,-7400,-1376300,12100,12100
72929,4,1627400,0,0,0,-1376300,12100,12100
72930,1,1387000,1387000,0,-1387000,-1387000,1400,1400
72930,2,1415600,283500,298400,14900,-1372100,16300,16300
72930,3,1519700,195600,182000,-13600,-1385700,2700,2700
72930,4,1589000,255700,266900,11200,-1374500,13900,13900
72931,1,1377300,1377300,0,-1377300,-1377300,11100,11100
72931,2,1414100,0,0,0,-1377300,11100,11100
72931,3,1468100,0,0,0,-1377300,11100,11100
72931,4,1520400,0,0,0,-1377300,11100,11100
72934,1,1385500,1385500,0,-1385500,-1385500,2900,2900
72934,2,1418900,176900,175000,-1900,-1387400,1000,1000
72934,3,1525300,213100,212200,-900,-1388300,100,100
72934,4,1637700,155700,160100,4400,-1383900,4500,4500
72935,1,1364300,1364300,0,-1364300,-1364300,24100,24100
72935,2,1426900,169900,147200,-22700,-1387000,1400,1400
72935,3,1480900,133400,170700,37300,-1349700,38700,38700
72935,4,1578600,0,0,0,-1349700,38700,38700
72936,1,1325000,1325000,0,-1325000,-1325000,63400,63400
72936,2,1309900,243200,315700,72500,-1252500,135900,135900
72936,3,1496600,206900,136500,-70400,-1322900,65500,65500
72936,4,1623200,257600,256800,-800,-1323700,64700,64700
72937,1,1385800,1385800,0,-1385800,-1385800,2600,2600
72937,2,1435500,0,0,0,-1385800,2600,2600
72937,3,1523500,0,0,0,-1385800,2600,2600
72937,4,1615300,0,0,0,-1385800,2600,2600
72938,1,1386100,1386100,0,-1386100,-1386100,2300,2300
72938,2,1420900,152600,163200,10600,-1375500,12900,12900
72938,3,1536300,111600,104000,-7600,-1383100,5300,5300
72938,4,1643600,227500,223800,-3700,-1386800,1600,1600
72940,1,1376800,1376800,0,-1376800,-1376800,11600,11600
72940,2,1349500,252800,309900,57100,-1319700,68700,68700
72940,3,1486500,225400,172300,-53100,-1372800,15600,15600
72940,4,1598300,165500,161900,-3600,-1376400,12000,12000
72943,1,1381400,1381400,0,-1381400,-1381400,7000,7000
72943,2,1403600,0,0,0,-1381400,7000,7000
72943,3,1438700,0,0,0,-1381400,7000,7000
72943,4,1476900,0,0,0,-1381400,7000,7000
72944,1,1384100,1384100,0,-1384100,-1384100,4300,4300
72944,2,1434300,215000,214800,-200,-1384300,4100,4100
72944,3,1499000,129200,147200,18000,-1366300,22100,22100
72944,4,1620000,204100,182300,-21800,-1388100,300,300
72945,1,1382600,1382600,0,-1382600,-1382600,5800,5800
72945,2,1431300,0,0,0,-1382600,5800,5800
72945,3,1503900,0,0,0,-1382600,5800,5800
72945,4,1586800,0,0,0,-1382600,5800,5800
72946,1,1385700,1385700,0,-1385700,-1385700,2700,2700
72946,2,1389200,0,0,0,-1385700,2700,2700
72946,3,1401700,0,0,0,-1385700,2700,2700
72946,4,1408700,0,0,0,-1385700,2700,2700
72947,1,1380400,1380400,0,-1380400,-1380400,8000,8000
72947,2,1425700,0,0,0,-1380400,8000,8000
72947,3,1465300,62500,77600,15100,-1365300,23100,23100
72947,4,1518700,0,0,0,-1365300,23100,23100
72948,1,1383900,1383900,0,-1383900,-1383900,4500,4500
72948,2,1432700,40600,37100,-3500,-1387400,1000,1000
72948,3,1524500,65900,68000,2100,-1385300,3100,3100
72948,4,1617100,171300,173500,2200,-1383100,5300,5300
72949,1,1248300,1248300,0,-1248300,-1248300,140100,140100
72949,2,1233600,0,0,0,-1248300,140100,140100
72949,3,1228800,0,0,0,-1248300,140100,140100
72949,4,1215100,0,0,0,-1248300,140100,140100
72952,1,1382200,1382200,0,-1382200,-1382200,6200,6200
72952,2,1368500,113600,161500,47900,-1334300,54100,54100
72952,3,1448600,263100,253900,-9200,-1343500,44900,44900
72952,4,1505700,181900,223400,41500,-1302000,86400,86400
72954,1,1367400,1367400,0,-1367400,-1367400,21000,21000
72954,2,1422700,0,0,0,-1367400,21000,21000
72954,3,1504300,0,0,0,-1367400,21000,21000
72954,4,1585100,0,0,0,-1367400,21000,21000
72956,1,1386100,1386100,0,-1386100,-1386100,2300,2300
72956,2,1426500,241500,246100,4600,-1381500,6900,6900
72956,3,1514100,173900,191600,17700,-1363800,24600,24600
72956,4,1646400,59900,47500,-12400,-1376200,12200,12200
72959,1,1382400,1382400,0,-1382400,-1382400,6000,6000
72959,2,1412600,240700,240700,0,-1382400,6000,6000
72959,3,1499800,234100,230300,-3800,-1386200,2200,2200
72959,4,1606000,124700,122900,-1800,-1388000,400,400
72960,1,1387200,1387200,0,-1387200,-1387200,1200,1200
72960,2,1450700,174700,181600,6900,-1380300,8100,8100
72960,3,1558700,149800,150800,1000,-1379300,9100,9100
72960,4,1654600,206700,207100,400,-1378900,9500,9500
72962,1,1375300,1375300,0,-1375300,-1375300,13100,13100
72962,2,1426600,140200,141600,1400,-1373900,14500,14500
72962,3,1535000,0,0,0,-1373900,14500,14500
72962,4,1651100,156800,149300,-7500,-1381400,7000,7000
72965,1,1054300,1054300,0,-1054300,-1054300,334100,334100
72965,2,1093100,0,0,0,-1054300,334100,334100
72965,3,1168400,0,0,0,-1054300,334100,334100
72965,4,1240800,0,0,0,-1054300,334100,334100
72966,1,1381400,1381400,0,-1381400,-1381400,7000,7000
72966,2,1428200,179900,183000,3100,-1378300,10100,10100
72966,3,1530800,159900,161700,1800,-1376500,11900,11900
72966,4,1638100,142100,130700,-11400,-1387900,500,500
72969,1,1385300,1385300,0,-1385300,-1385300,3100,3100
72969,2,1428700,0,0,0,-1385300,3100,3100
72969,3,1494000,0,0,0,-1385300,3100,3100
72969,4,1583300,0,0,0,-1385300,3100,3100
72970,1,1387800,1387800,0,-1387800,-1387800,600,600
72970,2,1401800,235100,236100,1000,-1386800,1600,1600
72970,3,1461800,156300,159500,3200,-1383600,4800,4800
72970,4,1511100,142500,154700,12200,-1371400,17000,17000
72971,1,1384300,1384300,0,-1384300,-1384300,4100,4100
72971,2,1431400,177300,174400,-2900,-1387200,1200,1200
72971,3,1535600,0,0,0,-1387200,1200,1200
72971,4,1640400,0,0,0,-1387200,1200,1200
72973,1,1361800,1361800,0,-1361800,-1361800,26600,26600
72973,2,1401900,109600,99900,-9700,-1371500,16900,16900
72973,3,1442800,157900,178400,20500,-1351000,37400,37400
72973,4,1553100,180900,145200,-35700,-1386700,1700,1700
72974,1,1386600,1386600,0,-1386600,-1386600,1800,1800
72974,2,1446600,345200,349500,4300,-1382300,6100,6100
72974,3,1552800,148100,142100,-6000,-1388300,100,100
72974,4,1659400,202000,203300,1300,-1387000,1400,1400
72976,1,1379100,1379100,0,-1379100,-1379100,9300,9300
72976,2,1404800,154300,161900,7600,-1371500,16900,16900
72976,3,1452800,0,0,0,-1371500,16900,16900
72976,4,1498600,0,0,0,-1371500,16900,16900
72977,1,1387100,1387100,0,-1387100,-1387100,1300,1300
72977,2,1456100,220800,221100,300,-1386800,1600,1600
72977,3,1555100,111200,133500,22300,-1364500,23900,23900
72977,4,1672400,71200,82300,11100,-1353400,35000,35000
72978,1,1377600,1377600,0,-1377600,-1377600,10800,10800
72978,2,1432700,236600,237800,1200,-1376400,12000,12000
72978,3,1534100,156500,161700,5200,-1371200,17200,17200
72978,4,1653700,252600,238600,-14000,-1385200,3200,3200
72980,1,1351600,1351600,0,-1351600,-1351600,36800,36800
72980,2,1407400,152600,130600,-22000,-1373600,14800,14800
72980,3,1407100,125700,210100,84400,-1289200,99200,99200
72980,4,1516900,194200,180200,-14000,-1303200,85200,85200
72981,1,1379800,1379800,0,-1379800,-1379800,8600,8600
72981,2,1395000,238600,238400,-200,-1380000,8400,8400
72981,3,1451000,151000,142800,-8200,-1388200,200,200
72981,4,1510400,185800,189300,3500,-1384700,3700,3700
72982,1,1383700,1383700,0,-1383700,-1383700,4700,4700
72982,2,1398400,236700,281800,45100,-1338600,49800,49800
72982,3,1554600,266700,219900,-46800,-1385400,3000,3000
72982,4,1651000,108600,120400,11800,-1373600,14800,14800
72983,1,1386300,1386300,0,-1386300,-1386300,2100,2100
72983,2,1420200,137300,140400,3100,-1383200,5200,5200
72983,3,1499400,188300,187800,-500,-1383700,4700,4700
72983,4,1588100,0,0,0,-1383700,4700,4700
72985,1,1381900,1381900,0,-1381900,-1381900,6500,6500
72985,2,1433900,0,0,0,-1381900,6500,6500
72985,3,1518900,138300,141100,2800,-1379100,9300,9300
72985,4,1625500,168000,169400,1400,-1377700,10700,10700
72986,1,1386400,1386400,0,-1386400,-1386400,2000,2000
72986,2,1389300,117400,163000,45600,-1340800,47600,47600
72986,3,1535200,164500,136100,-28400,-1369200,19200,19200
72986,4,1685500,155100,137300,-17800,-1387000,1400,1400
72987,1,1387200,1387200,0,-1387200,-1387200,1200,1200
72987,2,1438400,0,0,0,-1387200,1200,1200
72987,3,1477000,54200,68300,14100,-1373100,15300,15300
72987,4,1537000,0,0,0,-1373100,15300,15300
72988,1,1359700,1359700,0,-1359700,-1359700,28700,28700
72988,2,1384800,0,0,0,-1359700,28700,28700
72988,3,1430800,0,0,0,-1359700,28700,28700
72988,4,1502100,0,0,0,-1359700,28700,28700
72990,1,1382500,1382500,0,-1382500,-1382500,5900,5900
72990,2,1414200,217800,238100,20300,-1362200,26200,26200
72990,3,1513500,0,0,0,-1362200,26200,26200
72990,4,1600600,0,0,0,-1362200,26200,26200
72991,1,1381200,1381200,0,-1381200,-1381200,7200,7200
72991,2,1424300,0,0,0,-1381200,7200,7200
72991,3,1500000,0,0,0,-1381200,7200,7200
72991,4,1591200,0,0,0,-1381200,7200,7200
72992,1,1381800,1381800,0,-1381800,-1381800,6600,6600
72992,2,1414800,105700,114000,8300,-1373500,14900,14900
72992,3,1512900,264600,258200,-6400,-1379900,8500,8500
72992,4,1621900,129000,128500,-500,-1380400,8000,8000
72993,1,1367500,1367500,0,-1367500,-1367500,20900,20900
72993,2,1414700,0,0,0,-1367500,20900,20900
72993,3,1491700,0,0,0,-1367500,20900,20900
72993,4,1569700,0,0,0,-1367500,20900,20900
72994,1,1356100,1356100,0,-1356100,-1356100,32300,32300
72994,2,1413800,241500,228900,-12600,-1368700,19700,19700
72994,3,1544800,200900,182500,-18400,-1387100,1300,1300
72994,4,1647500,346300,346800,500,-1386600,1800,1800
72995,1,1369600,1369600,0,-1369600,-1369600,18800,18800
72995,2,1380900,114400,141800,27400,-1342200,46200,46200
72995,3,1515400,193700,162200,-31500,-1373700,14700,14700
72995,4,1620600,118000,116300,-1700,-1375400,13000,13000
72996,1,1329000,1329000,0,-1329000,-1329000,59400,59400
72996,2,1396000,179500,153100,-26400,-1355400,33000,33000
72996,3,1493300,169400,145300,-24100,-1379500,8900,8900
72996,4,1567300,221000,227400,6400,-1373100,15300,15300
72997,1,1372000,1372000,0,-1372000,-1372000,16400,16400
72997,2,1424000,146100,141300,-4800,-1376800,11600,11600
72997,3,1492600,170900,194000,23100,-1353700,34700,34700
72997,4,1605500,160600,141300,-19300,-1373000,15400,15400
72999,1,1368900,1368900,0,-1368900,-1368900,19500,19500
72999,2,1424800,157600,141100,-16500,-1385400,3000,3000
72999,3,1517500,132300,140600,8300,-1377100,11300,11300
72999,4,1628700,154100,147000,-7100,-1384200,4200,4200
73000,1,1382000,1382000,0,-1382000,-1382000,6400,6400
73000,2,1397200,107000,123600,16600,-1365400,23000,23000
73000,3,1458100,139000,124700,-14300,-1379700,8700,8700
73000,4,1514500,130600,127100,-3500,-1383200,5200,5200
73001,1,1328400,1328400,0,-1328400,-1328400,60000,60000
73001,2,1325900,0,0,0,-1328400,60000,60000
73001,3,1350000,0,0,0,-1328400,60000,60000
73001,4,1350000,0,0,0,-1328400,60000,60000
73002,1,1376500,1376500,0,-1376500,-1376500,11900,11900
73002,2,1427500,0,0,0,-1376500,11900,11900
73002,3,1507500,0,0,0,-1376500,11900,11900
73002,4,1599000,0,0,0,-1376500,11900,11900
73004,1,1378700,1378700,0,-1378700,-1378700,9700,9700
73004,2,1442200,218000,222300,4300,-1374400,14000,14000
73004,3,1548900,143000,145900,2900,-1371500,16900,16900
73004,4,1656600,0,0,0,-1371500,16900,16900
73005,1,1377700,1377700,0,-1377700,-1377700,10700,10700
73005,2,1432000,122800,114700,-8100,-1385800,2600,2600
73005,3,1523700,209600,208400,-1200,-1387000,1400,1400
73005,4,1635100,0,0,0,-1387000,1400,1400
73006,1,1385500,1385500,0,-1385500,-1385500,2900,2900
73006,2,1425300,0,0,0,-1385500,2900,2900
73006,3,1492400,0,0,0,-1385500,2900,2900
73006,4,1552700,0,0,0,-1385500,2900,2900
73007,1,1373300,1373300,0,-1373300,-1373300,15100,15100
73007,2,1443500,176900,168000,-8900,-1382200,6200,6200
73007,3,1517100,163300,208700,45400,-1336800,51600,51600
73007,4,1602400,183500,203700,20200,-1316600,71800,71800
73008,1,1384600,1384600,0,-1384600,-1384600,3800,3800
73008,2,1403500,159000,177500,18500,-1366100,22300,22300
73008,3,1512900,248600,247700,-900,-1367000,21400,21400
73008,4,1693200,125300,105800,-19500,-1386500,1900,1900
73012,1,1387700,1387700,0,-1387700,-1387700,700,700
73012,2,1440800,307000,310500,3500,-1384200,4200,4200
73012,3,1538200,137800,133800,-4000,-1388200,200,200
73012,4,1636200,142400,147000,4600,-1383600,4800,4800
73013,1,1381000,1381000,0,-1381000,-1381000,7400,7400
73013,2,1397200,0,0,0,-1381000,7400,7400
73013,3,1428200,0,0,0,-1381000,7400,7400
73013,4,1467600,0,0,0,-1381000,7400,7400
73018,1,1366200,1366200,0,-1366200,-1366200,22200,22200
73018,2,1360700,224300,270800,46500,-1319700,68700,68700
73018,3,1528200,174100,128700,-45400,-1365100,23300,23300
73018,4,1645300,0,0,0,-1365100,23300,23300
73021,1,1387400,1387400,0,-1387400,-1387400,1000,1000
73021,2,1404500,273600,287200,13600,-1373800,14600,14600
73021,3,1523800,150900,142100,-8800,-1382600,5800,5800
73021,4,1623800,200400,199600,-800,-1383400,5000,5000
73027,1,1381800,1381800,0,-1381800,-1381800,6600,6600
73027,2,1454600,174300,171900,-2400,-1384200,4200,4200
73027,3,1529800,134300,161700,27400,-1356800,31600,31600
73027,4,1670300,170300,143000,-27300,-1384100,4300,4300
73032,1,1348900,1348900,0,-1348900,-1348900,39500,39500
73032,2,1421500,177800,147900,-29900,-1378800,9600,9600
73032,3,1502000,0,0,0,-1378800,9600,9600
73032,4,1544400,166700,209700,43000,-1335800,52600,52600
73035,1,1388000,1388000,0,-1388000,-1388000,400,400
73035,2,1434400,116200,138100,21900,-1366100,22300,22300
73035,3,1563900,158300,142100,-16200,-1382300,6100,6100
73035,4,1610400,104200,183100,78900,-1303400,85000,85000
73036,1,1377000,1377000,0,-1377000,-1377000,11400,11400
73036,2,1431200,262400,255500,-6900,-1383900,4500,4500
73036,3,1536200,140600,142400,1800,-1382100,6300,6300
73036,4,1634400,265100,273400,8300,-1373800,14600,14600
73037,1,1376100,1376100,0,-1376100,-1376100,12300,12300
73037,2,1440600,138300,129500,-8800,-1384900,3500,3500
73037,3,1545800,0,0,0,-1384900,3500,3500
73037,4,1652200,150700,151400,700,-1384200,4200,4200
73038,1,1386800,1386800,0,-1386800,-1386800,1600,1600
73038,2,1442500,181600,183800,2200,-1384600,3800,3800
73038,3,1560400,271900,271200,-700,-1385300,3100,3100
73038,4,1651200,237200,280200,43000,-1342300,46100,46100
73040,1,1379500,1379500,0,-1379500,-1379500,8900,8900
73040,2,1430900,156800,162200,5400,-1374100,14300,14300
73040,3,1525600,149800,142100,-7700,-1381800,6600,6600
73040,4,1599300,97800,103200,5400,-1376400,12000,12000
73041,1,1365300,1365300,0,-1365300,-1365300,23100,23100
73041,2,1417100,198200,183000,-15200,-1380500,7900,7900
73041,3,1539900,238500,233100,-5400,-1385900,2500,2500
73041,4,1658700,205500,203400,-2100,-1388000,400,400
73042,1,1382500,1382500,0,-1382500,-1382500,5900,5900
73042,2,1451900,163900,158600,-5300,-1387800,600,600
73042,3,1546600,0,0,0,-1387800,600,600
73042,4,1637100,0,0,0,-1387800,600,600
73044,1,1383600,1383600,0,-1383600,-1383600,4800,4800
73044,2,1398900,144400,146300,1900,-1381700,6700,6700
73044,3,1474600,254800,258500,3700,-1378000,10400,10400
73044,4,1557400,168500,159400,-9100,-1387100,1300,1300
73045,1,1309700,1309700,0,-1309700,-1309700,78700,78700
73045,2,1372200,152600,141800,-10800,-1320500,67900,67900
73045,3,1529500,208100,148700,-59400,-1379900,8500,8500
73045,4,1614400,236600,236700,100,-1379800,8600,8600
73047,1,1355800,1355800,0,-1355800,-1355800,32600,32600
73047,2,1404100,105300,99900,-5400,-1361200,27200,27200
73047,3,1517600,201700,181700,-20000,-1381200,7200,7200
73047,4,1613100,184600,178600,-6000,-1387200,1200,1200
73051,1,1369500,1369500,0,-1369500,-1369500,18900,18900
73051,2,1434000,110500,93700,-16800,-1386300,2100,2100
73051,3,1530600,0,0,0,-1386300,2100,2100
73051,4,1606100,103300,105300,2000,-1384300,4100,4100
73052,1,1380200,1380200,0,-1380200,-1380200,8200,8200
73052,2,1432300,0,0,0,-1380200,8200,8200
73052,3,1507900,0,0,0,-1380200,8200,8200
73052,4,1598800,0,0,0,-1380200,8200,8200
73053,1,1370600,1370600,0,-1370600,-1370600,17800,17800
73053,2,1441800,0,0,0,-1370600,17800,17800
73053,3,1536000,0,0,0,-1370600,17800,17800
73053,4,1627900,0,0,0,-1370600,17800,17800
73054,1,1371200,1371200,0,-1371200,-1371200,17200,17200
73054,2,1420700,0,0,0,-1371200,17200,17200
73054,3,1495600,0,0,0,-1371200,17200,17200
73054,4,1571600,0,0,0,-1371200,17200,17200
73055,1,1386500,1386500,0,-1386500,-1386500,1900,1900
73055,2,1454800,0,0,0,-1386500,1900,1900
73055,3,1542200,0,0,0,-1386500,1900,1900
73055,4,1631600,161200,160200,-1000,-1387500,900,900
73057,1,1384400,1384400,0,-1384400,-1384400,4000,4000
73057,2,1425100,96500,93300,-3200,-1387600,800,800
73057,3,1470600,78100,77900,-200,-1387800,600,600
73057,4,1529800,52800,54700,1900,-1385900,2500,2500
73059,1,1387500,1387500,0,-1387500,-1387500,900,900
73059,2,1434900,0,0,0,-1387500,900,900
73059,3,1520900,0,0,0,-1387500,900,900
73059,4,1611900,0,0,0,-1387500,900,900
73061,1,1371900,1371900,0,-1371900,-1371900,16500,16500
73061,2,1392900,0,0,0,-1371900,16500,16500
73061,3,1458100,0,0,0,-1371900,16500,16500
73061,4,1520700,0,0,0,-1371900,16500,16500
73062,1,1379700,1379700,0,-1379700,-1379700,8700,8700
73062,2,1428600,181600,192600,11000,-1368700,19700,19700
73062,3,1557600,238100,226500,-11600,-1380300,8100,8100
73062,4,1676100,0,0,0,-1380300,8100,8100
73064,1,1382900,1382900,0,-1382900,-1382900,5500,5500
73064,2,1440200,0,0,0,-1382900,5500,5500
73064,3,1512800,0,0,0,-1382900,5500,5500
73064,4,1585700,0,0,0,-1382900,5500,5500
73065,1,1387300,1387300,0,-1387300,-1387300,1100,1100
73065,2,1403100,196200,205000,8800,-1378500,9900,9900
73065,3,1468300,238300,238600,300,-1378200,10200,10200
73065,4,1544900,119700,126100,6400,-1371800,16600,16600
73067,1,1377500,1377500,0,-1377500,-1377500,10900,10900
73067,2,1400800,0,0,0,-1377500,10900,10900
73067,3,1449000,0,0,0,-1377500,10900,10900
73067,4,1488200,0,0,0,-1377500,10900,10900
73068,1,1378900,1378900,0,-1378900,-1378900,9500,9500
73068,2,1438100,283300,275400,-7900,-1386800,1600,1600
73068,3,1478400,127100,195200,68100,-1318700,69700,69700
73068,4,1638800,289200,262600,-26600,-1345300,43100,43100
73073,1,1359200,1359200,0,-1359200,-1359200,29200,29200
73073,2,1416300,0,0,0,-1359200,29200,29200
73073,3,1500800,0,0,0,-1359200,29200,29200
73073,4,1584800,0,0,0,-1359200,29200,29200
73075,1,1381000,1381000,0,-1381000,-1381000,7400,7400
73075,2,1412800,178200,181100,2900,-1378100,10300,10300
73075,3,1514800,140200,130000,-10200,-1388300,100,100
73075,4,1567900,150900,158100,7200,-1381100,7300,7300
73076,1,1371300,1371300,0,-1371300,-1371300,17100,17100
73076,2,1422900,107400,104500,-2900,-1374200,14200,14200
73076,3,1509900,0,0,0,-1374200,14200,14200
73076,4,1596900,0,0,0,-1374200,14200,14200
73077,1,1362100,1362100,0,-1362100,-1362100,26300,26300
73077,2,1366800,202200,237800,35600,-1326500,61900,61900
73077,3,1510400,167400,132700,-34700,-1361200,27200,27200
73077,4,1641900,161900,154800,-7100,-1368300,20100,20100
73078,2,1352400,1352400,0,-1352400,-1352400,36000,36000
73078,3,1442200,0,0,0,-1352400,36000,36000
73078,4,1508300,0,0,0,-1352400,36000,36000
73079,1,1379600,1379600,0,-1379600,-1379600,8800,8800
73079,2,1422200,0,0,0,-1379600,8800,8800
73079,3,1512500,0,0,0,-1379600,8800,8800
73079,4,1591600,0,0,0,-1379600,8800,8800
73080,1,1383600,1383600,0,-1383600,-1383600,4800,4800
73080,2,1410500,110100,105500,-4600,-1388200,200,200
73080,3,1475500,203800,208700,4900,-1383300,5100,5100
73080,4,1549100,34800,36800,2000,-1381300,7100,7100
73081,1,1331700,1331700,0,-1331700,-1331700,56700,56700
73081,2,1418400,162800,108000,-54800,-1386500,1900,1900
73081,3,1497000,0,0,0,-1386500,1900,1900
73081,4,1556300,0,0,0,-1386500,1900,1900
73082,1,1384800,1384800,0,-1384800,-1384800,3600,3600
73082,2,1365200,174800,215400,40600,-1344200,44200,44200
73082,3,1483200,166000,122200,-43800,-1388000,400,400
73082,4,1566600,132800,132800,0,-1388000,400,400
73083,1,1387200,1387200,0,-1387200,-1387200,1200,1200
73083,2,1399600,0,0,0,-1387200,1200,1200
73083,3,1424700,151400,154100,2700,-1384500,3900,3900
73083,4,1462500,0,0,0,-1384500,3900,3900
73084,1,1373200,1373200,0,-1373200,-1373200,15200,15200
73084,2,1377200,0,0,0,-1373200,15200,15200
73084,3,1370900,0,0,0,-1373200,15200,15200
73084,4,1371600,0,0,0,-1373200,15200,15200
73085,1,1365400,1365400,0,-1365400,-1365400,23000,23000
73085,2,1413500,141900,128200,-13700,-1379100,9300,9300
73085,3,1470900,0,0,0,-1379100,9300,9300
73085,4,1520800,0,0,0,-1379100,9300,9300
73086,1,1386200,1386200,0,-1386200,-1386200,2200,2200
73086,2,1407000,241500,265100,23600,-1362600,25800,25800
73086,3,1523400,161300,142100,-19200,-1381800,6600,6600
73086,4,1639200,139500,135600,-3900,-1385700,2700,2700
73087,1,1370700,1370700,0,-1370700,-1370700,17700,17700
73087,2,1346000,281300,361400,80100,-1290600,97800,97800
73087,3,1494700,282700,244300,-38400,-1329000,59400,59400
73087,4,1680700,251400,193800,-57600,-1386600,1800,1800
73088,1,1385200,1385200,0,-1385200,-1385200,3200,3200
73088,2,1379100,0,0,0,-1385200,3200,3200
73088,3,1377300,0,0,0,-1385200,3200,3200
73088,4,1402600,0,0,0,-1385200,3200,3200
73089,1,1368400,1368400,0,-1368400,-1368400,20000,20000
73089,2,1380000,211300,222200,10900,-1357500,30900,30900
73089,3,1463800,247600,228500,-19100,-1376600,11800,11800
73089,4,1558500,153200,142100,-11100,-1387700,700,700
73093,1,1384200,1384200,0,-1384200,-1384200,4200,4200
73093,2,1436600,137300,141900,4600,-1379600,8800,8800
73093,3,1545500,0,0,0,-1379600,8800,8800
73093,4,1617900,176700,184500,7800,-1371800,16600,16600
73095,1,1377500,1377500,0,-1377500,-1377500,10900,10900
73095,2,1442200,99700,95300,-4400,-1381900,6500,6500
73095,3,1545800,147700,142100,-5600,-1387500,900,900
73095,4,1627200,125400,135900,10500,-1377000,11400,11400
73096,1,1387000,1387000,0,-1387000,-1387000,1400,1400
73096,2,1449200,298800,303900,5100,-1381900,6500,6500
73096,3,1551100,230600,225600,-5000,-1386900,1500,1500
73096,4,1640900,229000,240500,11500,-1375400,13000,13000
73097,1,1385500,1385500,0,-1385500,-1385500,2900,2900
73097,2,1429100,154600,175200,20600,-1364900,23500,23500
73097,3,1547900,170300,162500,-7800,-1372700,15700,15700
73097,4,1648300,187200,199900,12700,-1360000,28400,28400
73098,1,1383900,1383900,0,-1383900,-1383900,4500,4500
73098,2,1440600,159100,156800,-2300,-1386200,2200,2200
73098,3,1542700,207400,223700,16300,-1369900,18500,18500
73098,4,1690800,183400,169400,-14000,-1383900,4500,4500
73099,1,1360200,1360200,0,-1360200,-1360200,28200,28200
73099,2,1380500,246300,251300,5000,-1355200,33200,33200
73099,3,1456400,0,0,0,-1355200,33200,33200
73099,4,1533200,0,0,0,-1355200,33200,33200
73101,1,1385100,1385100,0,-1385100,-1385100,3300,3300
73101,2,1438400,175500,181800,6300,-1378800,9600,9600
73101,3,1566800,111200,111000,-200,-1379000,9400,9400
73101,4,1689000,68000,60800,-7200,-1386200,2200,2200
73102,1,1383200,1383200,0,-1383200,-1383200,5200,5200
73102,2,1430200,0,0,0,-1383200,5200,5200
73102,3,1506900,0,0,0,-1383200,5200,5200
73102,4,1585200,265900,262800,-3100,-1386300,2100,2100
73103,1,1384100,1384100,0,-1384100,-1384100,4300,4300
73103,2,1433700,162700,185600,22900,-1361200,27200,27200
73103,3,1596100,161300,135600,-25700,-1386900,1500,1500
73103,4,1720600,154700,156700,2000,-1384900,3500,3500
73105,1,1382400,1382400,0,-1382400,-1382400,6000,6000
73105,2,1403000,167300,182000,14700,-1367700,20700,20700
73105,3,1497200,228000,228400,400,-1367300,21100,21100
73105,4,1609800,0,0,0,-1367300,21100,21100
73107,1,1367400,1367400,0,-1367400,-1367400,21000,21000
73107,2,1407400,144400,141400,-3000,-1370400,18000,18000
73107,3,1505200,207500,197300,-10200,-1380600,7800,7800
73107,4,1590900,0,0,0,-1380600,7800,7800
73109,1,1382200,1382200,0,-1382200,-1382200,6200,6200
73109,2,1406300,0,0,0,-1382200,6200,6200
73109,3,1453700,0,0,0,-1382200,6200,6200
73109,4,1495000,31700,37900,6200,-1376000,12400,12400
73110,1,1384500,1384500,0,-1384500,-1384500,3900,3900
73110,2,1429600,0,0,0,-1384500,3900,3900
73110,3,1501100,0,0,0,-1384500,3900,3900
73110,4,1560900,0,0,0,-1384500,3900,3900
73113,1,1350500,1350500,0,-1350500,-1350500,37900,37900
73113,2,1441300,120100,94000,-26100,-1376600,11800,11800
73113,3,1528500,0,0,0,-1376600,11800,11800
73113,4,1603400,0,0,0,-1376600,11800,11800
73115,1,1385000,1385000,0,-1385000,-1385000,3400,3400
73115,2,1435600,194600,200800,6200,-1378800,9600,9600
73115,3,1537800,157200,159800,2600,-1376200,12200,12200
73115,4,1648500,164200,155200,-9000,-1385200,3200,3200
73116,1,1387000,1387000,0,-1387000,-1387000,1400,1400
73116,2,1424200,107100,118000,10900,-1376100,12300,12300
73116,3,1517500,153000,142100,-10900,-1387000,1400,1400
73116,4,1589100,131300,131200,-100,-1387100,1300,1300
73117,1,1387800,1387800,0,-1387800,-1387800,600,600
73117,2,1429200,156700,161000,4300,-1383500,4900,4900
73117,3,1523200,188000,185600,-2400,-1385900,2500,2500
73117,4,1542400,118300,188500,70200,-1315700,72700,72700
73118,1,1376500,1376500,0,-1376500,-1376500,11900,11900
73118,2,1427800,0,0,0,-1376500,11900,11900
73118,3,1490900,195700,213100,17400,-1359100,29300,29300
73118,4,1578400,0,0,0,-1359100,29300,29300
73119,1,1370200,1370200,0,-1370200,-1370200,18200,18200
73119,2,1425200,307000,296300,-10700,-1380900,7500,7500
73119,3,1497100,169800,184200,14400,-1366500,21900,21900
73119,4,1591600,175000,176200,1200,-1365300,23100,23100
73120,1,1370500,1370500,0,-1370500,-1370500,17900,17900
73120,2,1389000,0,0,0,-1370500,17900,17900
73120,3,1419700,0,0,0,-1370500,17900,17900
73120,4,1435600,0,0,0,-1370500,17900,17900
73121,1,1387800,1387800,0,-1387800,-1387800,600,600
73121,2,1407700,226600,237700,11100,-1376700,11700,11700
73121,3,1504600,200300,193300,-7000,-1383700,4700,4700
73121,4,1606400,304500,309600,5100,-1378600,9800,9800
73124,1,1381400,1381400,0,-1381400,-1381400,7000,7000
73124,2,1395900,0,0,0,-1381400,7000,7000
73124,3,1455500,0,0,0,-1381400,7000,7000
73124,4,1505200,0,0,0,-1381400,7000,7000
73125,1,1341100,1341100,0,-1341100,-1341100,47300,47300
73125,2,1415900,138400,108000,-30400,-1371500,16900,16900
73125,3,1520600,121100,105300,-15800,-1387300,1100,1100
73125,4,1641600,71600,71200,-400,-1387700,700,700
73126,1,1388200,1388200,0,-1388200,-1388200,200,200
73126,2,1427600,0,0,0,-1388200,200,200
73126,3,1497000,0,0,0,-1388200,200,200
73126,4,1565700,0,0,0,-1388200,200,200
73127,1,1385400,1385400,0,-1385400,-1385400,3000,3000
73127,2,1433800,198000,207000,9000,-1376400,12000,12000
73127,3,1544600,166100,161700,-4400,-1380800,7600,7600
73127,4,1641400,0,0,0,-1380800,7600,7600
73129,1,1356400,1356400,0,-1356400,-1356400,32000,32000
73129,2,1355400,209200,233700,24500,-1331900,56500,56500
73129,3,1391300,143000,178000,35000,-1296900,91500,91500
73129,4,1556000,250500,180200,-70300,-1367200,21200,21200
73134,1,1372600,1372600,0,-1372600,-1372600,15800,15800
73134,2,1410800,235300,253200,17900,-1354700,33700,33700
73134,3,1519100,267600,259900,-7700,-1362400,26000,26000
73134,4,1624900,0,0,0,-1362400,26000,26000
73136,1,1372400,1372400,0,-1372400,-1372400,16000,16000
73136,2,1469600,181600,165600,-16000,-1388400,0,0
73136,3,1585200,117800,142100,24300,-1364100,24300,24300
73136,4,1729700,161300,147300,-14000,-1378100,10300,10300
73139,1,1381100,1381100,0,-1381100,-1381100,7300,7300
73139,2,1399100,0,0,0,-1381100,7300,7300
73139,3,1447300,0,0,0,-1381100,7300,7300
73139,4,1505800,0,0,0,-1381100,7300,7300
73140,1,1385200,1385200,0,-1385200,-1385200,3200,3200
73140,2,1417600,206300,206500,200,-1385000,3400,3400
73140,3,1490900,223100,237000,13900,-1371100,17300,17300
73140,4,1608200,155100,154200,-900,-1372000,16400,16400
73141,1,1174000,1174000,0,-1174000,-1174000,214400,214400
73141,2,1183400,0,0,0,-1174000,214400,214400
73141,3,1311400,127500,40000,-87500,-1261500,126900,126900
73141,4,1376000,0,0,0,-1261500,126900,126900
73143,1,1376300,1376300,0,-1376300,-1376300,12100,12100
73143,2,1429200,98700,91600,-7100,-1383400,5000,5000
73143,3,1517300,0,0,0,-1383400,5000,5000
73143,4,1593500,257100,261300,4200,-1379200,9200,9200
73144,1,1371100,1371100,0,-1371100,-1371100,17300,17300
73144,2,1410000,0,0,0,-1371100,17300,17300
73144,3,1467000,0,0,0,-1371100,17300,17300
73144,4,1533100,0,0,0,-1371100,17300,17300
73145,1,1366500,1366500,0,-1366500,-1366500,21900,21900
73145,2,1412400,0,0,0,-1366500,21900,21900
73145,3,1481000,0,0,0,-1366500,21900,21900
73145,4,1565300,0,0,0,-1366500,21900,21900
73146,1,1346000,1346000,0,-1346000,-1346000,42400,42400
73146,2,1445000,137300,99500,-37800,-1383800,4600,4600
73146,3,1568200,175300,179800,4500,-1379300,9100,9100
73146,4,1695500,226900,222300,-4600,-1383900,4500,4500
73147,1,1386000,1386000,0,-1386000,-1386000,2400,2400
73147,2,1439300,0,0,0,-1386000,2400,2400
73147,3,1528400,0,0,0,-1386000,2400,2400
73147,4,1619300,0,0,0,-1386000,2400,2400
73150,1,1386100,1386100,0,-1386100,-1386100,2300,2300
73150,2,1421600,173800,195100,21300,-1364800,23600,23600
73150,3,1498000,85800,107800,22000,-1342800,45600,45600
73150,4,1634800,164200,123100,-41100,-1383900,4500,4500
73151,1,1375600,1375600,0,-1375600,-1375600,12800,12800
73151,2,1417900,305300,325400,20100,-1355500,32900,32900
73151,3,1545300,237800,213100,-24700,-1380200,8200,8200
73151,4,1642500,0,0,0,-1380200,8200,8200
73152,1,1350700,1350700,0,-1350700,-1350700,37700,37700
73152,2,1405500,0,0,0,-1350700,37700,37700
73152,3,1507300,98800,85800,-13000,-1363700,24700,24700
73152,4,1594800,0,0,0,-1363700,24700,24700
73153,1,1380000,1380000,0,-1380000,-1380000,8400,8400
73153,2,1393100,0,0,0,-1380000,8400,8400
73153,3,1416200,0,0,0,-1380000,8400,8400
73153,4,1420200,0,0,0,-1380000,8400,8400
73154,1,1385800,1385800,0,-1385800,-1385800,2600,2600
73154,2,1422900,114400,136500,22100,-1363700,24700,24700
73154,3,1560100,151700,131800,-19900,-1383600,4800,4800
73154,4,1648300,126500,134200,7700,-1375900,12500,12500
73155,1,1386300,1386300,0,-1386300,-1386300,2100,2100
73155,2,1440600,213500,216700,3200,-1383100,5300,5300
73155,3,1537200,195600,205200,9600,-1373500,14900,14900
73155,4,1648200,141800,133100,-8700,-1382200,6200,6200
73156,1,1386300,1386300,0,-1386300,-1386300,2100,2100
73156,2,1425000,282800,293900,11100,-1375200,13200,13200
73156,3,1530200,178800,166900,-11900,-1387100,1300,1300
73156,4,1635100,270200,269700,-500,-1387600,800,800
73157,1,1356600,1356600,0,-1356600,-1356600,31800,31800
73157,2,1445900,178100,162400,-15700,-1372300,16100,16100
73157,3,1558000,269400,277700,8300,-1364000,24400,24400
73157,4,1698700,317400,297100,-20300,-1384300,4100,4100
73159,1,1360800,1360800,0,-1360800,-1360800,27600,27600
73159,2,1448700,301000,276200,-24800,-1385600,2800,2800
73159,3,1540900,211200,226200,15000,-1370600,17800,17800
73159,4,1668300,139500,134300,-5200,-1375800,12600,12600
73160,1,1384900,1384900,0,-1384900,-1384900,3500,3500
73160,2,1446500,127700,124600,-3100,-1388000,400,400
73160,3,1563300,176400,176300,-100,-1388100,300,300
73160,4,1662800,193900,203100,9200,-1378900,9500,9500
73161,1,1362600,1362600,0,-1362600,-1362600,25800,25800
73161,2,1375500,74700,108700,34000,-1328600,59800,59800
73161,3,1499600,206700,172300,-34400,-1363000,25400,25400
73161,4,1626900,138200,120500,-17700,-1380700,7700,7700
73162,1,1388300,1388300,0,-1388300,-1388300,100,100
73162,2,1329600,243200,343300,100100,-1288200,100200,100200
73162,3,1494900,201000,113300,-87700,-1375900,12500,12500
73162,4,1590300,318300,308600,-9700,-1385600,2800,2800
73163,1,1379400,1379400,0,-1379400,-1379400,9000,9000
73163,2,1427100,0,0,0,-1379400,9000,9000
73163,3,1512300,0,0,0,-1379400,9000,9000
73163,4,1595100,0,0,0,-1379400,9000,9000
73164,1,1387600,1387600,0,-1387600,-1387600,800,800
73164,2,1435000,0,0,0,-1387600,800,800
73164,3,1500500,190800,197300,6500,-1381100,7300,7300
73164,4,1606200,0,0,0,-1381100,7300,7300
73165,1,1388300,1388300,0,-1388300,-1388300,100,100
73165,2,1436600,162700,169900,7200,-1381100,7300,7300
73165,3,1537400,206700,202900,-3800,-1384900,3500,3500
73165,4,1654900,0,0,0,-1384900,3500,3500
73167,1,1365600,1365600,0,-1365600,-1365600,22800,22800
73167,2,1439100,163600,152400,-11200,-1376800,11600,11600
73167,3,1541500,113800,108800,-5000,-1381800,6600,6600
73167,4,1610900,0,0,0,-1381800,6600,6600
73168,1,1380600,1380600,0,-1380600,-1380600,7800,7800
73168,2,1414600,0,0,0,-1380600,7800,7800
73168,3,1436900,82800,122000,39200,-1341400,47000,47000
73168,4,1516900,0,0,0,-1341400,47000,47000
73169,1,1386600,1386600,0,-1386600,-1386600,1800,1800
73169,2,1407800,113500,141900,28400,-1358200,30200,30200
73169,3,1540700,168600,139900,-28700,-1386900,1500,1500
73169,4,1661400,0,0,0,-1386900,1500,1500
73170,1,1388300,1388300,0,-1388300,-1388300,100,100
73170,2,1435500,0,0,0,-1388300,100,100
73170,3,1498200,123800,134000,10200,-1378100,10300,10300
73170,4,1586700,0,0,0,-1378100,10300,10300
73171,1,1360500,1360500,0,-1360500,-1360500,27900,27900
73171,2,1442600,169700,151600,-18100,-1378600,9800,9800
73171,3,1520400,156500,194700,38200,-1340400,48000,48000
73171,4,1663700,187800,146100,-41700,-1382100,6300,6300
73172,1,1361900,1361900,0,-1361900,-1361900,26500,26500
73172,2,1438500,113100,97100,-16000,-1377900,10500,10500
73172,3,1494900,181900,216400,34500,-1343400,45000,45000
73172,4,1599100,286700,297100,10400,-1333000,55400,55400
73173,1,1387400,1387400,0,-1387400,-1387400,1000,1000
73173,2,1416700,144300,153600,9300,-1378100,10300,10300
73173,3,1500300,0,0,0,-1378100,10300,10300
73173,4,1556600,0,0,0,-1378100,10300,10300
73174,1,1385800,1385800,0,-1385800,-1385800,2600,2600
73174,2,1378100,296000,358100,62100,-1323700,64700,64700
73174,3,1534600,209900,165800,-44100,-1367800,20600,20600
73174,4,1667100,167700,160900,-6800,-1374600,13800,13800
73175,1,1387900,1387900,0,-1387900,-1387900,500,500
73175,2,1427500,114000,134700,20700,-1367200,21200,21200
73175,3,1551700,158300,142100,-16200,-1383400,5000,5000
73175,4,1661300,170100,177100,7000,-1376400,12000,12000
73176,1,1386500,1386500,0,-1386500,-1386500,1900,1900
73176,2,1410400,179000,208900,29900,-1356600,31800,31800
73176,3,1512100,187600,199400,11800,-1344800,43600,43600
73176,4,1681000,163000,123900,-39100,-1383900,4500,4500
73177,1,1376500,1376500,0,-1376500,-1376500,11900,11900
73177,2,1361800,194900,271200,76300,-1300200,88200,88200
73177,3,1523100,214800,177900,-36900,-1337100,51300,51300
73177,4,1647200,0,0,0,-1337100,51300,51300
73178,1,1381900,1381900,0,-1381900,-1381900,6500,6500
73178,2,1389300,243000,254800,11800,-1370100,18300,18300
73178,3,1486600,198300,190800,-7500,-1377600,10800,10800
73178,4,1605100,159300,164900,5600,-1372000,16400,16400
73179,1,1298200,1298200,0,-1298200,-1298200,90200,90200
73179,2,1440600,294300,205400,-88900,-1387100,1300,1300
73179,3,1546400,0,0,0,-1387100,1300,1300
73179,4,1640200,0,0,0,-1387100,1300,1300
73180,1,1385100,1385100,0,-1385100,-1385100,3300,3300
73180,2,1407200,251900,271700,19800,-1365300,23100,23100
73180,3,1500000,187400,187600,200,-1365100,23300,23300
73180,4,1610900,212000,204500,-7500,-1372600,15800,15800
73181,1,1386400,1386400,0,-1386400,-1386400,2000,2000
73181,2,1426900,0,0,0,-1386400,2000,2000
73181,3,1513600,0,0,0,-1386400,2000,2000
73181,4,1587100,0,0,0,-1386400,2000,2000
73184,1,1380400,1380400,0,-1380400,-1380400,8000,8000
73184,2,1440100,222500,226900,4400,-1376000,12400,12400
73184,3,1537300,0,0,0,-1376000,12400,12400
73184,4,1621000,0,0,0,-1376000,12400,12400
73185,1,1382600,1382600,0,-1382600,-1382600,5800,5800
73185,2,1441500,306200,301400,-4800,-1387400,1000,1000
73185,3,1535000,270500,271300,800,-1386600,1800,1800
73185,4,1648900,124000,123500,-500,-1387100,1300,1300
73186,1,1375600,1375600,0,-1375600,-1375600,12800,12800
73186,2,1426600,0,0,0,-1375600,12800,12800
73186,3,1506500,0,0,0,-1375600,12800,12800
73186,4,1595500,0,0,0,-1375600,12800,12800
73187,1,1371200,1371200,0,-1371200,-1371200,17200,17200
73187,2,1399000,203800,228000,24200,-1347000,41400,41400
73187,3,1499900,0,0,0,-1347000,41400,41400
73187,4,1599700,0,0,0,-1347000,41400,41400
73188,1,1370000,1370000,0,-1370000,-1370000,18400,18400
73188,2,1433700,0,0,0,-1370000,18400,18400
73188,3,1525000,0,0,0,-1370000,18400,18400
73188,4,1612900,0,0,0,-1370000,18400,18400
73191,1,1370400,1370400,0,-1370400,-1370400,18000,18000
73191,2,1391500,222900,255500,32600,-1337800,50600,50600
73191,3,1537800,189900,142100,-47800,-1385600,2800,2800
73191,4,1599900,198700,235900,37200,-1348400,40000,40000
73192,1,1384900,1384900,0,-1384900,-1384900,3500,3500
73192,2,1458400,171500,171000,-500,-1385400,3000,3000
73192,3,1570900,143200,142100,-1100,-1386500,1900,1900
73192,4,1655500,260800,286400,25600,-1360900,27500,27500
73193,1,1383900,1383900,0,-1383900,-1383900,4500,4500
73193,2,1419500,174200,172500,-1700,-1385600,2800,2800
73193,3,1454400,170600,168600,-2000,-1387600,800,800
73193,4,1497000,132400,133500,1100,-1386500,1900,1900
73194,1,1363700,1363700,0,-1363700,-1363700,24700,24700
73194,2,1415900,150000,135500,-14500,-1378200,10200,10200
73194,3,1479600,208900,230200,21300,-1356900,31500,31500
73194,4,1582900,160500,150400,-10100,-1367000,21400,21400
73196,1,1386300,1386300,0,-1386300,-1386300,2100,2100
73196,2,1457700,179900,180300,400,-1385900,2500,2500
73196,3,1580500,146200,145900,-300,-1386200,2200,2200
73196,4,1701400,131200,135400,4200,-1382000,6400,6400
73198,1,1334100,1334100,0,-1334100,-1334100,54300,54300
73198,2,1391200,0,0,0,-1334100,54300,54300
73198,3,1476900,0,0,0,-1334100,54300,54300
73198,4,1557900,0,0,0,-1334100,54300,54300
73199,1,1384600,1384600,0,-1384600,-1384600,3800,3800
73199,2,1441600,0,0,0,-1384600,3800,3800
73199,3,1522300,0,0,0,-1384600,3800,3800
73199,4,1612900,0,0,0,-1384600,3800,3800
73200,1,1388000,1388000,0,-1388000,-1388000,400,400
73200,2,1400000,116000,140500,24500,-1363500,24900,24900
73200,3,1478000,183900,161900,-22000,-1385500,2900,2900
73200,4,1542200,0,0,0,-1385500,2900,2900
73201,1,1354700,1354700,0,-1354700,-1354700,33700,33700
73201,2,1423700,76400,59500,-16900,-1371600,16800,16800
73201,3,1499900,0,0,0,-1371600,16800,16800
73201,4,1579900,159300,144200,-15100,-1386700,1700,1700
73202,1,1387500,1387500,0,-1387500,-1387500,900,900
73202,2,1424100,195900,198400,2500,-1385000,3400,3400
73202,3,1502100,256500,259800,3300,-1381700,6700,6700
73202,4,1605600,279200,276100,-3100,-1384800,3600,3600
73203,1,1376000,1376000,0,-1376000,-1376000,12400,12400
73203,2,1456900,203100,191200,-11900,-1387900,500,500
73203,3,1568400,183800,191400,7600,-1380300,8100,8100
73203,4,1700000,246900,246900,0,-1380300,8100,8100
73204,1,1367800,1367800,0,-1367800,-1367800,20600,20600
73204,2,1417400,134700,127000,-7700,-1375500,12900,12900
73204,3,1527200,0,0,0,-1375500,12900,12900
73204,4,1575800,162200,207800,45600,-1329900,58500,58500
73205,1,1354400,1354400,0,-1354400,-1354400,34000,34000
73205,2,1412800,0,0,0,-1354400,34000,34000
73205,3,1488700,0,0,0,-1354400,34000,34000
73205,4,1576500,0,0,0,-1354400,34000,34000
73206,1,1360600,1360600,0,-1360600,-1360600,27800,27800
73206,2,1429400,0,0,0,-1360600,27800,27800
73206,3,1507400,267400,270300,2900,-1357700,30700,30700
73206,4,1616300,0,0,0,-1357700,30700,30700
73207,1,1386200,1386200,0,-1386200,-1386200,2200,2200
73207,2,1423300,240600,264200,23600,-1362600,25800,25800
73207,3,1560400,158300,136500,-21800,-1384400,4000,4000
73207,4,1684200,169400,166600,-2800,-1387200,1200,1200
73208,1,1373200,1373200,0,-1373200,-1373200,15200,15200
73208,2,1392200,287300,315600,28300,-1344900,43500,43500
73208,3,1541400,188000,150000,-38000,-1382900,5500,5500
73208,4,1659700,129200,126400,-2800,-1385700,2700,2700
73209,1,1381900,1381900,0,-1381900,-1381900,6500,6500
73209,2,1421300,302200,304100,1900,-1380000,8400,8400
73209,3,1519400,197600,190600,-7000,-1387000,1400,1400
73209,4,1620300,202200,208100,5900,-1381100,7300,7300
73211,1,1384400,1384400,0,-1384400,-1384400,4000,4000
73211,2,1426800,0,0,0,-1384400,4000,4000
73211,3,1495100,0,0,0,-1384400,4000,4000
73211,4,1579000,0,0,0,-1384400,4000,4000
73212,1,1386200,1386200,0,-1386200,-1386200,2200,2200
73212,2,1427000,163800,164100,300,-1385900,2500,2500
73212,3,1520100,213100,210800,-2300,-1388200,200,200
73212,4,1618000,0,0,0,-1388200,200,200
73213,1,1387500,1387500,0,-1387500,-1387500,900,900
73213,2,1406200,181600,210000,28400,-1359100,29300,29300
73213,3,1514500,28700,37900,9200,-1349900,38500,38500
73213,4,1618300,36000,47500,11500,-1338400,50000,50000
73214,1,1380200,1380200,0,-1380200,-1380200,8200,8200
73214,2,1423200,167700,160000,-7700,-1387900,500,500
73214,3,1515200,173100,176900,3800,-1384100,4300,4300
73214,4,1629800,239100,236600,-2500,-1386600,1800,1800
73215,1,1380400,1380400,0,-1380400,-1380400,8000,8000
73215,2,1435900,107400,99400,-8000,-1388400,0,0
73215,3,1533800,132700,140300,7600,-1380800,7600,7600
73215,4,1634500,165900,165000,-900,-1381700,6700,6700
73216,1,1382300,1382300,0,-1382300,-1382300,6100,6100
73216,2,1430200,0,0,0,-1382300,6100,6100
73216,3,1482700,0,0,0,-1382300,6100,6100
73216,4,1534800,0,0,0,-1382300,6100,6100
73217,1,1387300,1387300,0,-1387300,-1387300,1100,1100
73217,2,1446200,224000,229400,5400,-1381900,6500,6500
73217,3,1550300,183100,195400,12300,-1369600,18800,18800
73217,4,1701300,152900,137300,-15600,-1385200,3200,3200
73218,1,1383900,1383900,0,-1383900,-1383900,4500,4500
73218,2,1433700,223400,235600,12200,-1371700,16700,16700
73218,3,1561200,169800,161700,-8100,-1379800,8600,8600
73218,4,1690900,164200,156700,-7500,-1387300,1100,1100
73219,1,1388400,1388400,0,-1388400,-1388400,0,0
73219,2,1393700,0,0,0,-1388400,0,0
73219,3,1440500,0,0,0,-1388400,0,0
73219,4,1502800,0,0,0,-1388400,0,0
73220,1,1382200,1382200,0,-1382200,-1382200,6200,6200
73220,2,1381000,60300,60900,600,-1381600,6800,6800
73220,3,1388200,54200,50500,-3700,-1385300,3100,3100
73220,4,1383200,0,0,0,-1385300,3100,3100
73221,1,1374500,1374500,0,-1374500,-1374500,13900,13900
73221,2,1405000,0,0,0,-1374500,13900,13900
73221,3,1431500,0,0,0,-1374500,13900,13900
73221,4,1462700,123900,117100,-6800,-1381300,7100,7100
73222,1,1376000,1376000,0,-1376000,-1376000,12400,12400
73222,2,1418700,228500,216700,-11800,-1387800,600,600
73222,3,1457600,237100,273600,36500,-1351300,37100,37100
73222,4,1601100,164100,146000,-18100,-1369400,19000,19000
73225,1,1385000,1385000,0,-1385000,-1385000,3400,3400
73225,2,1422200,177400,209400,32000,-1353000,35400,35400
73225,3,1572100,195000,160600,-34400,-1387400,1000,1000
73225,4,1683400,243400,252700,9300,-1378100,10300,10300
73226,1,1386200,1386200,0,-1386200,-1386200,2200,2200
73226,2,1452900,0,0,0,-1386200,2200,2200
73226,3,1542000,0,0,0,-1386200,2200,2200
73226,4,1630700,0,0,0,-1386200,2200,2200
73228,1,1357400,1357400,0,-1357400,-1357400,31000,31000
73228,2,1399200,178100,189100,11000,-1346400,42000,42000
73228,3,1549700,173400,141500,-31900,-1378300,10100,10100
73228,4,1651500,107000,118700,11700,-1366600,21800,21800
73230,1,1388200,1388200,0,-1388200,-1388200,200,200
73230,2,1411100,93600,94700,1100,-1387100,1300,1300
73230,3,1448200,155000,157700,2700,-1384400,4000,4000
73230,4,1518900,99100,95900,-3200,-1387600,800,800
73231,1,1364500,1364500,0,-1364500,-1364500,23900,23900
73231,2,1353400,243200,309900,66700,-1297800,90600,90600
73231,3,1531000,219900,142100,-77800,-1375600,12800,12800
73231,4,1633500,130500,130500,0,-1375600,12800,12800
73232,1,1386300,1386300,0,-1386300,-1386300,2100,2100
73232,2,1433700,315600,326900,11300,-1375000,13400,13400
73232,3,1511800,174600,192700,18100,-1356900,31500,31500
73232,4,1626100,209700,200900,-8800,-1365700,22700,22700
73233,1,1384000,1384000,0,-1384000,-1384000,4400,4400
73233,2,1429400,0,0,0,-1384000,4400,4400
73233,3,1469400,236300,262900,26600,-1357400,31000,31000
73233,4,1557200,0,0,0,-1357400,31000,31000
73235,1,1356800,1356800,0,-1356800,-1356800,31600,31600
73235,2,1409600,0,0,0,-1356800,31600,31600
73235,3,1500000,0,0,0,-1356800,31600,31600
73235,4,1589200,0,0,0,-1356800,31600,31600
73236,1,1373000,1373000,0,-1373000,-1373000,15400,15400
73236,2,1442700,175600,163200,-12400,-1385400,3000,3000
73236,3,1549000,132300,142100,9800,-1375600,12800,12800
73236,4,1678700,123000,120100,-2900,-1378500,9900,9900
73237,1,1358400,1358400,0,-1358400,-1358400,30000,30000
73237,2,1408700,0,0,0,-1358400,30000,30000
73237,3,1506800,297100,280100,-17000,-1375400,13000,13000
73237,4,1597800,0,0,0,-1375400,13000,13000
73238,1,1332300,1332300,0,-1332300,-1332300,56100,56100
73238,2,1375100,0,0,0,-1332300,56100,56100
73238,3,1514500,111800,64700,-47100,-1379400,9000,9000
73238,4,1614600,0,0,0,-1379400,9000,9000
73239,1,1374000,1374000,0,-1374000,-1374000,14400,14400
73239,2,1422200,33700,30100,-3600,-1377600,10800,10800
73239,3,1523400,152400,142100,-10300,-1387900,500,500
73239,4,1631900,0,0,0,-1387900,500,500
73240,1,1376000,1376000,0,-1376000,-1376000,12400,12400
73240,2,1444300,184300,182900,-1400,-1377400,11000,11000
73240,3,1572100,149800,142100,-7700,-1385100,3300,3300
73240,4,1692500,163200,160300,-2900,-1388000,400,400
73241,1,1387400,1387400,0,-1387400,-1387400,1000,1000
73241,2,1401500,219800,265800,46000,-1341400,47000,47000
73241,3,1558100,176600,142400,-34200,-1375600,12800,12800
73241,4,1688900,145300,135600,-9700,-1385300,3100,3100
73243,1,1380200,1380200,0,-1380200,-1380200,8200,8200
73243,2,1401900,93400,85200,-8200,-1388400,0,0
73243,3,1417900,168000,184600,16600,-1371800,16600,16600
73243,4,1484000,210400,208500,-1900,-1373700,14700,14700
73244,1,1345100,1345100,0,-1345100,-1345100,43300,43300
73244,2,1388500,0,0,0,-1345100,43300,43300
73244,3,1459700,0,0,0,-1345100,43300,43300
73244,4,1529000,0,0,0,-1345100,43300,43300
73245,1,1388400,1388400,0,-1388400,-1388400,0,0
73245,2,1423800,217700,223800,6100,-1382300,6100,6100
73245,3,1525600,238200,240700,2500,-1379800,8600,8600
73245,4,1647400,142800,143600,800,-1379000,9400,9400
73246,1,1329900,1329900,0,-1329900,-1329900,58500,58500
73246,2,1423500,113500,92600,-20900,-1350800,37600,37600
73246,3,1560800,164500,139900,-24600,-1375400,13000,13000
73246,4,1698000,143000,131000,-12000,-1387400,1000,1000
73247,1,1349800,1349800,0,-1349800,-1349800,38600,38600
73247,2,1448200,283100,254200,-28900,-1378700,9700,9700
73247,3,1536700,121700,142100,20400,-1358300,30100,30100
73247,4,1648600,0,0,0,-1358300,30100,30100
73248,1,1381400,1381400,0,-1381400,-1381400,7000,7000
73248,2,1439900,0,0,0,-1381400,7000,7000
73248,3,1531200,0,0,0,-1381400,7000,7000
73248,4,1636800,0,0,0,-1381400,7000,7000
73249,1,1381100,1381100,0,-1381100,-1381100,7300,7300
73249,2,1329300,226600,310200,83600,-1297500,90900,90900
73249,3,1446400,248600,225200,-23400,-1320900,67500,67500
73249,4,1640600,246200,181300,-64900,-1385800,2600,2600
73250,1,1377800,1377800,0,-1377800,-1377800,10600,10600
73250,2,1438600,288500,279400,-9100,-1386900,1500,1500
73250,3,1548300,196700,196000,-700,-1387600,800,800
73250,4,1670000,114000,115000,1000,-1386600,1800,1800
73252,1,1382800,1382800,0,-1382800,-1382800,5600,5600
73252,2,1414300,0,0,0,-1382800,5600,5600
73252,3,1454100,0,0,0,-1382800,5600,5600
73252,4,1483900,0,0,0,-1382800,5600,5600
73253,1,1378100,1378100,0,-1378100,-1378100,10300,10300
73253,2,1402200,285600,309900,24300,-1353800,34600,34600
73253,3,1531700,172700,142100,-30600,-1384400,4000,4000
73253,4,1572700,108600,179600,71000,-1313400,75000,75000
73254,1,1381400,1381400,0,-1381400,-1381400,7000,7000
73254,2,1393900,175000,213200,38200,-1343200,45200,45200
73254,3,1509500,181200,160900,-20300,-1363500,24900,24900
73254,4,1636000,0,0,0,-1363500,24900,24900
73255,1,1387300,1387300,0,-1387300,-1387300,1100,1100
73255,2,1380300,175200,195000,19800,-1367500,20900,20900
73255,3,1449500,120300,104800,-15500,-1383000,5400,5400
73255,4,1487800,0,0,0,-1383000,5400,5400
73258,1,1297200,1297200,0,-1297200,-1297200,91200,91200
73258,2,1385300,181600,130600,-51000,-1348200,40200,40200
73258,3,1496500,153600,120700,-32900,-1381100,7300,7300
73258,4,1579100,248600,262100,13500,-1367600,20800,20800
73260,1,1386000,1386000,0,-1386000,-1386000,2400,2400
73260,2,1432300,268800,266400,-2400,-1388400,0,0
73260,3,1520300,202000,216700,14700,-1373700,14700,14700
73260,4,1621000,232700,229900,-2800,-1376500,11900,11900
73261,1,1333400,1333400,0,-1333400,-1333400,55000,55000
73261,2,1389800,0,0,0,-1333400,55000,55000
73261,3,1483500,0,0,0,-1333400,55000,55000
73261,4,1575800,0,0,0,-1333400,55000,55000
73262,1,1382500,1382500,0,-1382500,-1382500,5900,5900
73262,2,1439900,162700,167300,4600,-1377900,10500,10500
73262,3,1566400,179300,175500,-3800,-1381700,6700,6700
73262,4,1692300,133600,127900,-5700,-1387400,1000,1000
73263,1,1384400,1384400,0,-1384400,-1384400,4000,4000
73263,2,1430300,0,0,0,-1384400,4000,4000
73263,3,1504600,0,0,0,-1384400,4000,4000
73263,4,1600100,0,0,0,-1384400,4000,4000
73264,1,1376500,1376500,0,-1376500,-1376500,11900,11900
73264,2,1420800,0,0,0,-1376500,11900,11900
73264,3,1495800,73300,67400,-5900,-1382400,6000,6000
73264,4,1583800,0,0,0,-1382400,6000,6000
73266,1,1386200,1386200,0,-1386200,-1386200,2200,2200
73266,2,1350200,219800,309900,90100,-1296100,92300,92300
73266,3,1465300,0,0,0,-1296100,92300,92300
73266,4,1616700,192600,149200,-43400,-1339500,48900,48900
73267,1,1363700,1363700,0,-1363700,-1363700,24700,24700
73267,2,1422400,0,0,0,-1363700,24700,24700
73267,3,1518200,0,0,0,-1363700,24700,24700
73267,4,1616000,0,0,0,-1363700,24700,24700
73268,1,1387100,1387100,0,-1387100,-1387100,1300,1300
73268,2,1438900,160300,162400,2100,-1385000,3400,3400
73268,3,1531300,143200,142200,-1000,-1386000,2400,2400
73268,4,1640800,163000,166800,3800,-1382200,6200,6200
73269,1,1375700,1375700,0,-1375700,-1375700,12700,12700
73269,2,1406400,0,0,0,-1375700,12700,12700
73269,3,1470500,0,0,0,-1375700,12700,12700
73269,4,1549600,0,0,0,-1375700,12700,12700
73270,1,1374500,1374500,0,-1374500,-1374500,13900,13900
73270,2,1426600,267300,256300,-11000,-1385500,2900,2900
73270,3,1498400,107000,105300,-1700,-1387200,1200,1200
73270,4,1577500,0,0,0,-1387200,1200,1200
73271,1,1388100,1388100,0,-1388100,-1388100,300,300
73271,2,1429800,0,0,0,-1388100,300,300
73271,3,1479400,0,0,0,-1388100,300,300
73271,4,1528500,99400,104200,4800,-1383300,5100,5100
73272,1,1369400,1369400,0,-1369400,-1369400,19000,19000
73272,2,1430300,0,0,0,-1369400,19000,19000
73272,3,1527200,0,0,0,-1369400,19000,19000
73272,4,1622300,0,0,0,-1369400,19000,19000
73273,1,1343700,1343700,0,-1343700,-1343700,44700,44700
73273,2,1386100,0,0,0,-1343700,44700,44700
73273,3,1450700,0,0,0,-1343700,44700,44700
73273,4,1507300,0,0,0,-1343700,44700,44700
73274,1,1385400,1385400,0,-1385400,-1385400,3000,3000
73274,2,1417200,0,0,0,-1385400,3000,3000
73274,3,1384500,199300,289500,90200,-1295200,93200,93200
73274,4,1480200,0,0,0,-1295200,93200,93200
73275,1,1381700,1381700,0,-1381700,-1381700,6700,6700
73275,2,1423000,0,0,0,-1381700,6700,6700
73275,3,1506000,0,0,0,-1381700,6700,6700
73275,4,1599500,0,0,0,-1381700,6700,6700
73277,1,1111300,1111300,0,-1111300,-1111300,277100,277100
73277,2,1171500,0,0,0,-1111300,277100,277100
73277,3,1244700,0,0,0,-1111300,277100,277100
73277,4,1303100,0,0,0,-1111300,277100,277100
73278,1,1352800,1352800,0,-1352800,-1352800,35600,35600
73278,2,1419400,0,0,0,-1352800,35600,35600
73278,3,1519500,0,0,0,-1352800,35600,35600
73278,4,1622200,0,0,0,-1352800,35600,35600
73279,1,1383500,1383500,0,-1383500,-1383500,4900,4900
73279,2,1419400,0,0,0,-1383500,4900,4900
73279,3,1467800,176400,187500,11100,-1372400,16000,16000
73279,4,1567000,135900,120000,-15900,-1388300,100,100
73280,1,1386100,1386100,0,-1386100,-1386100,2300,2300
73280,2,1429000,0,0,0,-1386100,2300,2300
73280,3,1504700,0,0,0,-1386100,2300,2300
73280,4,1567700,102700,104200,1500,-1384600,3800,3800
73281,1,1388200,1388200,0,-1388200,-1388200,200,200
73281,2,1418800,182500,187300,4800,-1383400,5000,5000
73281,3,1525300,0,0,0,-1383400,5000,5000
73281,4,1600100,0,0,0,-1383400,5000,5000
73283,1,1374700,1374700,0,-1374700,-1374700,13700,13700
73283,2,1422600,177700,174700,-3000,-1377700,10700,10700
73283,3,1513900,0,0,0,-1377700,10700,10700
73283,4,1609600,0,0,0,-1377700,10700,10700
73284,1,1388300,1388300,0,-1388300,-1388300,100,100
73284,2,1435300,0,0,0,-1388300,100,100
73284,3,1485100,0,0,0,-1388300,100,100
73284,4,1524100,0,0,0,-1388300,100,100
73285,1,1388200,1388200,0,-1388200,-1388200,200,200
73285,2,1441200,69300,73000,3700,-1384500,3900,3900
73285,3,1498600,162800,196100,33300,-1351200,37200,37200
73285,4,1622400,183200,153800,-29400,-1380600,7800,7800
73286,1,1386600,1386600,0,-1386600,-1386600,1800,1800
73286,2,1420600,174600,183600,9000,-1377600,10800,10800
73286,3,1484500,135200,147600,12400,-1365200,23200,23200
73286,4,1549700,0,0,0,-1365200,23200,23200
73287,1,1374900,1374900,0,-1374900,-1374900,13500,13500
73287,2,1429800,0,0,0,-1374900,13500,13500
73287,3,1510400,0,0,0,-1374900,13500,13500
73287,4,1596100,0,0,0,-1374900,13500,13500
73289,1,1348800,1348800,0,-1348800,-1348800,39600,39600
73289,2,1415400,181600,172400,-9200,-1358000,30400,30400
73289,3,1549200,175400,150000,-25400,-1383400,5000,5000
73289,4,1651700,289800,287500,-2300,-1385700,2700,2700
73290,1,1378800,1378800,0,-1378800,-1378800,9600,9600
73290,2,1430700,241300,231900,-9400,-1388200,200,200
73290,3,1524800,278200,284200,6000,-1382200,6200,6200
73290,4,1621100,266800,262000,-4800,-1387000,1400,1400
73291,1,1386800,1386800,0,-1386800,-1386800,1600,1600
73291,2,1421300,0,0,0,-1386800,1600,1600
73291,3,1462500,0,0,0,-1386800,1600,1600
73291,4,1497000,0,0,0,-1386800,1600,1600
73292,1,1366200,1366200,0,-1366200,-1366200,22200,22200
73292,2,1431800,0,0,0,-1366200,22200,22200
73292,3,1532200,0,0,0,-1366200,22200,22200
73292,4,1623500,0,0,0,-1366200,22200,22200
73293,1,1338600,1338600,0,-1338600,-1338600,49800,49800
73293,2,1384600,0,0,0,-1338600,49800,49800
73293,3,1453200,0,0,0,-1338600,49800,49800
73293,4,1513200,0,0,0,-1338600,49800,49800
73296,1,1365900,1365900,0,-1365900,-1365900,22500,22500
73296,2,1415400,201500,197700,-3800,-1369700,18700,18700
73296,3,1463800,174400,213100,38700,-1331000,57400,57400
73296,4,1599800,289700,242000,-47700,-1378700,9700,9700
73299,2,1374200,1374200,0,-1374200,-1374200,14200,14200
73299,3,1462800,146000,179000,33000,-1341200,47200,47200
73299,4,1600000,238500,199900,-38600,-1379800,8600,8600
73306,2,1383800,1383800,0,-1383800,-1383800,4600,4600
73306,3,1495900,0,0,0,-1383800,4600,4600
73306,4,1580800,0,0,0,-1383800,4600,4600
73318,2,1385600,1385600,0,-1385600,-1385600,2800,2800
73318,3,1499600,59800,75000,15200,-1370400,18000,18000
73318,4,1631700,196900,186100,-10800,-1381200,7200,7200
73321,2,1312800,1312800,0,-1312800,-1312800,75600,75600
73321,3,1454000,0,0,0,-1312800,75600,75600
73321,4,1652100,334400,260600,-73800,-1386600,1800,1800
73322,2,1350800,1350800,0,-1350800,-1350800,37600,37600
73322,3,1397000,0,0,0,-1350800,37600,37600
73322,4,1462900,243400,220700,-22700,-1373500,14900,14900
73326,2,1338600,1338600,0,-1338600,-1338600,49800,49800
73326,3,1468100,0,0,0,-1338600,49800,49800
73326,4,1580900,0,0,0,-1338600,49800,49800
73341,2,1387700,1387700,0,-1387700,-1387700,700,700
73341,3,1489200,0,0,0,-1387700,700,700
73341,4,1565100,113200,141800,28600,-1359100,29300,29300
73354,3,1387000,1387000,0,-1387000,-1387000,1400,1400
73354,4,1490600,117500,124900,7400,-1379600,8800,8800
73359,2,1358400,1358400,0,-1358400,-1358400,30000,30000
73359,3,1504600,0,0,0,-1358400,30000,30000
73359,4,1637600,181400,164800,-16600,-1375000,13400,13400
73360,2,1375800,1375800,0,-1375800,-1375800,12600,12600
73360,3,1467100,0,0,0,-1375800,12600,12600
73360,4,1544600,0,0,0,-1375800,12600,12600
73362,2,1380000,1380000,0,-1380000,-1380000,8400,8400
73362,3,1517300,0,0,0,-1380000,8400,8400
73362,4,1648600,0,0,0,-1380000,8400,8400
73363,2,1387900,1387900,0,-1387900,-1387900,500,500
73363,3,1406200,0,0,0,-1387900,500,500
73363,4,1448900,0,0,0,-1387900,500,500
73369,2,1366400,1366400,0,-1366400,-1366400,22000,22000
73369,3,1457300,172700,182800,10100,-1356300,32100,32100
73369,4,1603400,173200,142300,-30900,-1387200,1200,1200
73371,2,1378100,1378100,0,-1378100,-1378100,10300,10300
73371,3,1440100,0,0,0,-1378100,10300,10300
73371,4,1506500,0,0,0,-1378100,10300,10300
73372,2,1387700,1387700,0,-1387700,-1387700,700,700
73372,3,1456300,147600,151400,3800,-1383900,4500,4500
73372,4,1554400,131500,127900,-3600,-1387500,900,900
73373,2,1384300,1384300,0,-1384300,-1384300,4100,4100
73373,3,1437600,187500,238200,50700,-1333600,54800,54800
73373,4,1593000,238800,191100,-47700,-1381300,7100,7100
73374,2,1377300,1377300,0,-1377300,-1377300,11100,11100
73374,3,1490300,0,0,0,-1377300,11100,11100
73374,4,1574000,0,0,0,-1377300,11100,11100
73376,2,1376300,1376300,0,-1376300,-1376300,12100,12100
73376,3,1533900,0,0,0,-1376300,12100,12100
73376,4,1671000,0,0,0,-1376300,12100,12100
73377,2,1382600,1382600,0,-1382600,-1382600,5800,5800
73377,3,1520900,0,0,0,-1382600,5800,5800
73377,4,1630600,0,0,0,-1382600,5800,5800
73379,2,1340600,1340600,0,-1340600,-1340600,47800,47800
73379,3,1514600,175400,142100,-33300,-1373900,14500,14500
73379,4,1641400,172100,165600,-6500,-1380400,8000,8000
73380,2,1385400,1385400,0,-1385400,-1385400,3000,3000
73380,3,1501700,0,0,0,-1385400,3000,3000
73380,4,1606400,147800,145400,-2400,-1387800,600,600
73390,3,1382300,1382300,0,-1382300,-1382300,6100,6100
73390,4,1489500,165300,178800,13500,-1368800,19600,19600
73393,4,1387200,1387200,0,-1387200,-1387200,1200,1200
