"","member_id","round_id","teamValue","inTotal","outTotal","tradesTotal","CumTrades","remaining","cashcheck"
"1",72028,1,1366800,1366800,0,-1366800,-1366800,21600,21600
"2",72031,1,1206300,1206300,0,-1206300,-1206300,182100,182100
"3",72032,1,1387600,1387600,0,-1387600,-1387600,800,800
"4",72033,1,1376800,1376800,0,-1376800,-1376800,11600,11600
"5",72034,1,1386800,1386800,0,-1386800,-1386800,1600,1600
"6",72035,1,1386800,1386800,0,-1386800,-1386800,1600,1600
"7",72036,1,1387800,1387800,0,-1387800,-1387800,600,600
"8",72038,1,1384400,1384400,0,-1384400,-1384400,4000,4000
"9",72040,1,1386900,1386900,0,-1386900,-1386900,1500,1500
"10",72041,1,1380300,1380300,0,-1380300,-1380300,8100,8100
"11",72042,1,1387800,1387800,0,-1387800,-1387800,600,600
"12",72044,1,1382200,1382200,0,-1382200,-1382200,6200,6200
"13",72045,1,1387600,1387600,0,-1387600,-1387600,800,800
"14",72046,1,1372400,1372400,0,-1372400,-1372400,16000,16000
"15",72047,1,1386100,1386100,0,-1386100,-1386100,2300,2300
"16",72048,1,1382400,1382400,0,-1382400,-1382400,6000,6000
"17",72049,1,1386700,1386700,0,-1386700,-1386700,1700,1700
"18",72050,1,1356600,1356600,0,-1356600,-1356600,31800,31800
"19",72051,1,1384500,1384500,0,-1384500,-1384500,3900,3900
"20",72052,1,1369400,1369400,0,-1369400,-1369400,19000,19000
"21",72053,1,1386600,1386600,0,-1386600,-1386600,1800,1800
"22",72054,1,1380500,1380500,0,-1380500,-1380500,7900,7900
"23",72056,1,1372900,1372900,0,-1372900,-1372900,15500,15500
"24",72057,1,1367100,1367100,0,-1367100,-1367100,21300,21300
"25",72058,1,1379700,1379700,0,-1379700,-1379700,8700,8700
"26",72060,1,1365900,1365900,0,-1365900,-1365900,22500,22500
"27",72061,1,1385600,1385600,0,-1385600,-1385600,2800,2800
"28",72064,1,1359100,1359100,0,-1359100,-1359100,29300,29300
"29",72066,1,1383000,1383000,0,-1383000,-1383000,5400,5400
"30",72067,1,1384900,1384900,0,-1384900,-1384900,3500,3500
"31",72068,1,1384700,1384700,0,-1384700,-1384700,3700,3700
"32",72069,1,1387600,1387600,0,-1387600,-1387600,800,800
"33",72071,1,1378900,1378900,0,-1378900,-1378900,9500,9500
"34",72073,1,1380000,1380000,0,-1380000,-1380000,8400,8400
"35",72075,1,1385400,1385400,0,-1385400,-1385400,3000,3000
"36",72076,1,602700,602700,0,-602700,-602700,785700,785700
"37",72077,1,1386100,1386100,0,-1386100,-1386100,2300,2300
"38",72079,1,1376400,1376400,0,-1376400,-1376400,12000,12000
"39",72080,1,1375900,1375900,0,-1375900,-1375900,12500,12500
"40",72081,1,1384200,1384200,0,-1384200,-1384200,4200,4200
"41",72085,1,1387600,1387600,0,-1387600,-1387600,800,800
"42",72088,1,602700,602700,0,-602700,-602700,785700,785700
"43",72089,1,1343600,1343600,0,-1343600,-1343600,44800,44800
"44",72090,1,1383800,1383800,0,-1383800,-1383800,4600,4600
"45",72091,1,1383200,1383200,0,-1383200,-1383200,5200,5200
"46",72092,1,1385200,1385200,0,-1385200,-1385200,3200,3200
"47",72096,1,1374000,1374000,0,-1374000,-1374000,14400,14400
"48",72098,1,1375000,1375000,0,-1375000,-1375000,13400,13400
"49",72099,1,1368300,1368300,0,-1368300,-1368300,20100,20100
"50",72100,1,1383700,1383700,0,-1383700,-1383700,4700,4700
"51",72101,1,1375900,1375900,0,-1375900,-1375900,12500,12500
"52",72103,1,1387400,1387400,0,-1387400,-1387400,1000,1000
"53",72104,1,1324500,1324500,0,-1324500,-1324500,63900,63900
"54",72106,1,1374800,1374800,0,-1374800,-1374800,13600,13600
"55",72108,1,1373300,1373300,0,-1373300,-1373300,15100,15100
"56",72109,1,1378700,1378700,0,-1378700,-1378700,9700,9700
"57",72111,1,1365700,1365700,0,-1365700,-1365700,22700,22700
"58",72112,1,1383700,1383700,0,-1383700,-1383700,4700,4700
"59",72113,1,1378800,1378800,0,-1378800,-1378800,9600,9600
"60",72114,1,1366200,1366200,0,-1366200,-1366200,22200,22200
"61",72115,1,1341800,1341800,0,-1341800,-1341800,46600,46600
"62",72119,1,1380500,1380500,0,-1380500,-1380500,7900,7900
"63",72120,1,1363500,1363500,0,-1363500,-1363500,24900,24900
"64",72121,1,1378600,1378600,0,-1378600,-1378600,9800,9800
"65",72122,1,1381000,1381000,0,-1381000,-1381000,7400,7400
"66",72123,1,1384700,1384700,0,-1384700,-1384700,3700,3700
"67",72124,1,1378800,1378800,0,-1378800,-1378800,9600,9600
"68",72125,1,1379800,1379800,0,-1379800,-1379800,8600,8600
"69",72127,1,1378700,1378700,0,-1378700,-1378700,9700,9700
"70",72128,1,1386000,1386000,0,-1386000,-1386000,2400,2400
"71",72129,1,1342400,1342400,0,-1342400,-1342400,46000,46000
"72",72130,1,1375000,1375000,0,-1375000,-1375000,13400,13400
"73",72131,1,1360500,1360500,0,-1360500,-1360500,27900,27900
"74",72132,1,1375400,1375400,0,-1375400,-1375400,13000,13000
"75",72133,1,1361700,1361700,0,-1361700,-1361700,26700,26700
"76",72136,1,1371800,1371800,0,-1371800,-1371800,16600,16600
"77",72138,1,1388200,1388200,0,-1388200,-1388200,200,200
"78",72139,1,1378000,1378000,0,-1378000,-1378000,10400,10400
"79",72140,1,1381200,1381200,0,-1381200,-1381200,7200,7200
"80",72141,1,1373800,1373800,0,-1373800,-1373800,14600,14600
"81",72143,1,1377400,1377400,0,-1377400,-1377400,11000,11000
"82",72145,1,1383400,1383400,0,-1383400,-1383400,5000,5000
"83",72146,1,1383300,1383300,0,-1383300,-1383300,5100,5100
"84",72148,1,1375400,1375400,0,-1375400,-1375400,13000,13000
"85",72149,1,1380800,1380800,0,-1380800,-1380800,7600,7600
"86",72150,1,1354000,1354000,0,-1354000,-1354000,34400,34400
"87",72151,1,1382100,1382100,0,-1382100,-1382100,6300,6300
"88",72152,1,1386000,1386000,0,-1386000,-1386000,2400,2400
"89",72153,1,1367400,1367400,0,-1367400,-1367400,21000,21000
"90",72154,1,1388400,1388400,0,-1388400,-1388400,0,0
"91",72155,1,1381900,1381900,0,-1381900,-1381900,6500,6500
"92",72157,1,1386600,1386600,0,-1386600,-1386600,1800,1800
"93",72158,1,1377700,1377700,0,-1377700,-1377700,10700,10700
"94",72159,1,1381500,1381500,0,-1381500,-1381500,6900,6900
"95",72160,1,1385700,1385700,0,-1385700,-1385700,2700,2700
"96",72161,1,1388400,1388400,0,-1388400,-1388400,0,0
"97",72162,1,1383100,1383100,0,-1383100,-1383100,5300,5300
"98",72163,1,1386700,1386700,0,-1386700,-1386700,1700,1700
"99",72164,1,1353200,1353200,0,-1353200,-1353200,35200,35200
"100",72166,1,1385700,1385700,0,-1385700,-1385700,2700,2700
"101",72167,1,1340000,1340000,0,-1340000,-1340000,48400,48400
"102",72168,1,1373800,1373800,0,-1373800,-1373800,14600,14600
"103",72172,1,1375400,1375400,0,-1375400,-1375400,13000,13000
"104",72173,1,1384700,1384700,0,-1384700,-1384700,3700,3700
"105",72176,1,1379400,1379400,0,-1379400,-1379400,9000,9000
"106",72178,1,1387600,1387600,0,-1387600,-1387600,800,800
"107",72180,1,1372200,1372200,0,-1372200,-1372200,16200,16200
"108",72182,1,1386900,1386900,0,-1386900,-1386900,1500,1500
"109",72183,1,1373200,1373200,0,-1373200,-1373200,15200,15200
"110",72184,1,1350300,1350300,0,-1350300,-1350300,38100,38100
"111",72186,1,1387700,1387700,0,-1387700,-1387700,700,700
"112",72187,1,1360600,1360600,0,-1360600,-1360600,27800,27800
"113",72188,1,1381800,1381800,0,-1381800,-1381800,6600,6600
"114",72190,1,1379100,1379100,0,-1379100,-1379100,9300,9300
"115",72191,1,1352800,1352800,0,-1352800,-1352800,35600,35600
"116",72194,1,1386800,1386800,0,-1386800,-1386800,1600,1600
"117",72198,1,1382200,1382200,0,-1382200,-1382200,6200,6200
"118",72199,1,1293500,1293500,0,-1293500,-1293500,94900,94900
"119",72201,1,1382000,1382000,0,-1382000,-1382000,6400,6400
"120",72204,1,1386600,1386600,0,-1386600,-1386600,1800,1800
"121",72206,1,1377100,1377100,0,-1377100,-1377100,11300,11300
"122",72207,1,1384000,1384000,0,-1384000,-1384000,4400,4400
"123",72209,1,1385500,1385500,0,-1385500,-1385500,2900,2900
"124",72211,1,1387200,1387200,0,-1387200,-1387200,1200,1200
"125",72212,1,1378800,1378800,0,-1378800,-1378800,9600,9600
"126",72215,1,1332300,1332300,0,-1332300,-1332300,56100,56100
"127",72216,1,1388100,1388100,0,-1388100,-1388100,300,300
"128",72217,1,1378900,1378900,0,-1378900,-1378900,9500,9500
"129",72218,1,1381100,1381100,0,-1381100,-1381100,7300,7300
"130",72221,1,1387800,1387800,0,-1387800,-1387800,600,600
"131",72222,1,1385700,1385700,0,-1385700,-1385700,2700,2700
"132",72223,1,1380400,1380400,0,-1380400,-1380400,8000,8000
"133",72225,1,1369500,1369500,0,-1369500,-1369500,18900,18900
"134",72227,1,1386800,1386800,0,-1386800,-1386800,1600,1600
"135",72232,1,1381500,1381500,0,-1381500,-1381500,6900,6900
"136",72234,1,1387500,1387500,0,-1387500,-1387500,900,900
"137",72235,1,1376300,1376300,0,-1376300,-1376300,12100,12100
"138",72239,1,1375800,1375800,0,-1375800,-1375800,12600,12600
"139",72243,1,1387500,1387500,0,-1387500,-1387500,900,900
"140",72247,1,1383500,1383500,0,-1383500,-1383500,4900,4900
"141",72250,1,1386700,1386700,0,-1386700,-1386700,1700,1700
"142",72251,1,1380000,1380000,0,-1380000,-1380000,8400,8400
"143",72253,1,1371600,1371600,0,-1371600,-1371600,16800,16800
"144",72254,1,1385200,1385200,0,-1385200,-1385200,3200,3200
"145",72255,1,1305500,1305500,0,-1305500,-1305500,82900,82900
"146",72260,1,1355600,1355600,0,-1355600,-1355600,32800,32800
"147",72261,1,1381100,1381100,0,-1381100,-1381100,7300,7300
"148",72263,1,1368300,1368300,0,-1368300,-1368300,20100,20100
"149",72264,1,1381000,1381000,0,-1381000,-1381000,7400,7400
"150",72265,1,1388400,1388400,0,-1388400,-1388400,0,0
"151",72267,1,1383100,1383100,0,-1383100,-1383100,5300,5300
"152",72268,1,1370600,1370600,0,-1370600,-1370600,17800,17800
"153",72271,1,1384400,1384400,0,-1384400,-1384400,4000,4000
"154",72273,1,1387400,1387400,0,-1387400,-1387400,1000,1000
"155",72274,1,1380200,1380200,0,-1380200,-1380200,8200,8200
"156",72275,1,1386600,1386600,0,-1386600,-1386600,1800,1800
"157",72277,1,1384800,1384800,0,-1384800,-1384800,3600,3600
"158",72280,1,1382600,1382600,0,-1382600,-1382600,5800,5800
"159",72283,1,1387100,1387100,0,-1387100,-1387100,1300,1300
"160",72291,1,1388100,1388100,0,-1388100,-1388100,300,300
"161",72292,1,1336400,1336400,0,-1336400,-1336400,52000,52000
"162",72300,1,1369500,1369500,0,-1369500,-1369500,18900,18900
"163",72301,1,1375700,1375700,0,-1375700,-1375700,12700,12700
"164",72302,1,1355500,1355500,0,-1355500,-1355500,32900,32900
"165",72311,1,1236700,1236700,0,-1236700,-1236700,151700,151700
"166",72315,1,1387200,1387200,0,-1387200,-1387200,1200,1200
"167",72323,1,1382700,1382700,0,-1382700,-1382700,5700,5700
"168",72325,1,1378600,1378600,0,-1378600,-1378600,9800,9800
"169",72327,1,1387300,1387300,0,-1387300,-1387300,1100,1100
"170",72329,1,1382700,1382700,0,-1382700,-1382700,5700,5700
"171",72331,1,1384300,1384300,0,-1384300,-1384300,4100,4100
"172",72335,1,1351600,1351600,0,-1351600,-1351600,36800,36800
"173",72336,1,1385500,1385500,0,-1385500,-1385500,2900,2900
"174",72337,1,1377900,1377900,0,-1377900,-1377900,10500,10500
"175",72338,1,1385400,1385400,0,-1385400,-1385400,3000,3000
"176",72340,1,1388200,1388200,0,-1388200,-1388200,200,200
"177",72341,1,1381400,1381400,0,-1381400,-1381400,7000,7000
"178",72363,1,1370900,1370900,0,-1370900,-1370900,17500,17500
"179",72364,1,1369900,1369900,0,-1369900,-1369900,18500,18500
"180",72371,1,1383200,1383200,0,-1383200,-1383200,5200,5200
"181",72372,1,1387000,1387000,0,-1387000,-1387000,1400,1400
"182",72389,1,1385300,1385300,0,-1385300,-1385300,3100,3100
"183",72391,1,1354500,1354500,0,-1354500,-1354500,33900,33900
"184",72393,1,1385600,1385600,0,-1385600,-1385600,2800,2800
"185",72401,1,1382900,1382900,0,-1382900,-1382900,5500,5500
"186",72402,1,1387200,1387200,0,-1387200,-1387200,1200,1200
"187",72405,1,1386100,1386100,0,-1386100,-1386100,2300,2300
"188",72408,1,1386000,1386000,0,-1386000,-1386000,2400,2400
"189",72411,1,1381900,1381900,0,-1381900,-1381900,6500,6500
"190",72413,1,1370900,1370900,0,-1370900,-1370900,17500,17500
"191",72414,1,1388000,1388000,0,-1388000,-1388000,400,400
"192",72416,1,1380100,1380100,0,-1380100,-1380100,8300,8300
"193",72420,1,1380100,1380100,0,-1380100,-1380100,8300,8300
"194",72423,1,1385400,1385400,0,-1385400,-1385400,3000,3000
"195",72427,1,1387600,1387600,0,-1387600,-1387600,800,800
"196",72432,1,1387200,1387200,0,-1387200,-1387200,1200,1200
"197",72433,1,1383700,1383700,0,-1383700,-1383700,4700,4700
"198",72438,1,1361100,1361100,0,-1361100,-1361100,27300,27300
"199",72440,1,1387600,1387600,0,-1387600,-1387600,800,800
"200",72441,1,1378400,1378400,0,-1378400,-1378400,10000,10000
"201",72444,1,1383700,1383700,0,-1383700,-1383700,4700,4700
"202",72451,1,1367900,1367900,0,-1367900,-1367900,20500,20500
"203",72452,1,1388400,1388400,0,-1388400,-1388400,0,0
"204",72459,1,1384500,1384500,0,-1384500,-1384500,3900,3900
"205",72460,1,1387500,1387500,0,-1387500,-1387500,900,900
"206",72465,1,1382000,1382000,0,-1382000,-1382000,6400,6400
"207",72467,1,1375100,1375100,0,-1375100,-1375100,13300,13300
"208",72468,1,1384900,1384900,0,-1384900,-1384900,3500,3500
"209",72472,1,1195800,1195800,0,-1195800,-1195800,192600,192600
"210",72474,1,1382100,1382100,0,-1382100,-1382100,6300,6300
"211",72479,1,1387600,1387600,0,-1387600,-1387600,800,800
"212",72480,1,1383900,1383900,0,-1383900,-1383900,4500,4500
"213",72490,1,1388400,1388400,0,-1388400,-1388400,0,0
"214",72491,1,1363200,1363200,0,-1363200,-1363200,25200,25200
"215",72492,1,1315600,1315600,0,-1315600,-1315600,72800,72800
"216",72502,1,1387900,1387900,0,-1387900,-1387900,500,500
"217",72505,1,1387100,1387100,0,-1387100,-1387100,1300,1300
"218",72506,1,1386600,1386600,0,-1386600,-1386600,1800,1800
"219",72512,1,1388400,1388400,0,-1388400,-1388400,0,0
"220",72513,1,1388400,1388400,0,-1388400,-1388400,0,0
"221",72514,1,1386400,1386400,0,-1386400,-1386400,2000,2000
"222",72519,1,1371000,1371000,0,-1371000,-1371000,17400,17400
"223",72524,1,1386300,1386300,0,-1386300,-1386300,2100,2100
"224",72531,1,1380300,1380300,0,-1380300,-1380300,8100,8100
"225",72533,1,1387600,1387600,0,-1387600,-1387600,800,800
"226",72534,1,1383700,1383700,0,-1383700,-1383700,4700,4700
"227",72537,1,1388000,1388000,0,-1388000,-1388000,400,400
"228",72538,1,1385600,1385600,0,-1385600,-1385600,2800,2800
"229",72539,1,1369800,1369800,0,-1369800,-1369800,18600,18600
"230",72540,1,1352800,1352800,0,-1352800,-1352800,35600,35600
"231",72541,1,1370800,1370800,0,-1370800,-1370800,17600,17600
"232",72545,1,1360200,1360200,0,-1360200,-1360200,28200,28200
"233",72548,1,1381600,1381600,0,-1381600,-1381600,6800,6800
"234",72549,1,1382600,1382600,0,-1382600,-1382600,5800,5800
"235",72552,1,1381000,1381000,0,-1381000,-1381000,7400,7400
"236",72553,1,1388000,1388000,0,-1388000,-1388000,400,400
"237",72556,1,1381100,1381100,0,-1381100,-1381100,7300,7300
"238",72557,1,1381300,1381300,0,-1381300,-1381300,7100,7100
"239",72560,1,1381900,1381900,0,-1381900,-1381900,6500,6500
"240",72563,1,1388200,1388200,0,-1388200,-1388200,200,200
"241",72565,1,1288000,1288000,0,-1288000,-1288000,100400,100400
"242",72566,1,1378300,1378300,0,-1378300,-1378300,10100,10100
"243",72567,1,1379500,1379500,0,-1379500,-1379500,8900,8900
"244",72570,1,1383800,1383800,0,-1383800,-1383800,4600,4600
"245",72577,1,1386100,1386100,0,-1386100,-1386100,2300,2300
"246",72579,1,1364300,1364300,0,-1364300,-1364300,24100,24100
"247",72580,1,1353300,1353300,0,-1353300,-1353300,35100,35100
"248",72582,1,1382000,1382000,0,-1382000,-1382000,6400,6400
"249",72584,1,1387100,1387100,0,-1387100,-1387100,1300,1300
"250",72587,1,1380800,1380800,0,-1380800,-1380800,7600,7600
"251",72589,1,1387200,1387200,0,-1387200,-1387200,1200,1200
"252",72590,1,1384700,1384700,0,-1384700,-1384700,3700,3700
"253",72591,1,1379600,1379600,0,-1379600,-1379600,8800,8800
"254",72593,1,1381900,1381900,0,-1381900,-1381900,6500,6500
"255",72594,1,1387300,1387300,0,-1387300,-1387300,1100,1100
"256",72596,1,1386200,1386200,0,-1386200,-1386200,2200,2200
"257",72600,1,1383600,1383600,0,-1383600,-1383600,4800,4800
"258",72601,1,1385900,1385900,0,-1385900,-1385900,2500,2500
"259",72603,1,1383100,1383100,0,-1383100,-1383100,5300,5300
"260",72605,1,1387900,1387900,0,-1387900,-1387900,500,500
"261",72606,1,1387900,1387900,0,-1387900,-1387900,500,500
"262",72609,1,1377500,1377500,0,-1377500,-1377500,10900,10900
"263",72610,1,1383400,1383400,0,-1383400,-1383400,5000,5000
"264",72611,1,1384500,1384500,0,-1384500,-1384500,3900,3900
"265",72612,1,1377900,1377900,0,-1377900,-1377900,10500,10500
"266",72614,1,1385900,1385900,0,-1385900,-1385900,2500,2500
"267",72615,1,1387900,1387900,0,-1387900,-1387900,500,500
"268",72622,1,1386600,1386600,0,-1386600,-1386600,1800,1800
"269",72623,1,1306800,1306800,0,-1306800,-1306800,81600,81600
"270",72624,1,1368000,1368000,0,-1368000,-1368000,20400,20400
"271",72630,1,1365400,1365400,0,-1365400,-1365400,23000,23000
"272",72631,1,1380200,1380200,0,-1380200,-1380200,8200,8200
"273",72632,1,1387600,1387600,0,-1387600,-1387600,800,800
"274",72633,1,1388100,1388100,0,-1388100,-1388100,300,300
"275",72634,1,1359000,1359000,0,-1359000,-1359000,29400,29400
"276",72635,1,1382400,1382400,0,-1382400,-1382400,6000,6000
"277",72636,1,1376000,1376000,0,-1376000,-1376000,12400,12400
"278",72639,1,1386100,1386100,0,-1386100,-1386100,2300,2300
"279",72641,1,1359100,1359100,0,-1359100,-1359100,29300,29300
"280",72642,1,1375500,1375500,0,-1375500,-1375500,12900,12900
"281",72643,1,1381700,1381700,0,-1381700,-1381700,6700,6700
"282",72644,1,1386400,1386400,0,-1386400,-1386400,2000,2000
"283",72646,1,1387000,1387000,0,-1387000,-1387000,1400,1400
"284",72647,1,1380800,1380800,0,-1380800,-1380800,7600,7600
"285",72648,1,1364600,1364600,0,-1364600,-1364600,23800,23800
"286",72649,1,1388100,1388100,0,-1388100,-1388100,300,300
"287",72651,1,1381600,1381600,0,-1381600,-1381600,6800,6800
"288",72654,1,1378600,1378600,0,-1378600,-1378600,9800,9800
"289",72656,1,1361300,1361300,0,-1361300,-1361300,27100,27100
"290",72657,1,1388400,1388400,0,-1388400,-1388400,0,0
"291",72660,1,1388300,1388300,0,-1388300,-1388300,100,100
"292",72662,1,1357300,1357300,0,-1357300,-1357300,31100,31100
"293",72664,1,1379400,1379400,0,-1379400,-1379400,9000,9000
"294",72666,1,1386400,1386400,0,-1386400,-1386400,2000,2000
"295",72667,1,1373500,1373500,0,-1373500,-1373500,14900,14900
"296",72668,1,1368400,1368400,0,-1368400,-1368400,20000,20000
"297",72669,1,1381200,1381200,0,-1381200,-1381200,7200,7200
"298",72670,1,1379700,1379700,0,-1379700,-1379700,8700,8700
"299",72671,1,1371900,1371900,0,-1371900,-1371900,16500,16500
"300",72672,1,1356200,1356200,0,-1356200,-1356200,32200,32200
"301",72673,1,1385600,1385600,0,-1385600,-1385600,2800,2800
"302",72674,1,1322200,1322200,0,-1322200,-1322200,66200,66200
"303",72675,1,1381800,1381800,0,-1381800,-1381800,6600,6600
"304",72676,1,1376400,1376400,0,-1376400,-1376400,12000,12000
"305",72677,1,1374400,1374400,0,-1374400,-1374400,14000,14000
"306",72678,1,1381400,1381400,0,-1381400,-1381400,7000,7000
"307",72679,1,1388400,1388400,0,-1388400,-1388400,0,0
"308",72680,1,1384200,1384200,0,-1384200,-1384200,4200,4200
"309",72681,1,1370600,1370600,0,-1370600,-1370600,17800,17800
"310",72682,1,1387700,1387700,0,-1387700,-1387700,700,700
"311",72684,1,1344800,1344800,0,-1344800,-1344800,43600,43600
"312",72685,1,1363000,1363000,0,-1363000,-1363000,25400,25400
"313",72687,1,1352800,1352800,0,-1352800,-1352800,35600,35600
"314",72689,1,1371600,1371600,0,-1371600,-1371600,16800,16800
"315",72690,1,1327800,1327800,0,-1327800,-1327800,60600,60600
"316",72692,1,1380600,1380600,0,-1380600,-1380600,7800,7800
"317",72693,1,1384900,1384900,0,-1384900,-1384900,3500,3500
"318",72695,1,1382700,1382700,0,-1382700,-1382700,5700,5700
"319",72697,1,1388300,1388300,0,-1388300,-1388300,100,100
"320",72699,1,1370500,1370500,0,-1370500,-1370500,17900,17900
"321",72701,1,1369900,1369900,0,-1369900,-1369900,18500,18500
"322",72702,1,1374300,1374300,0,-1374300,-1374300,14100,14100
"323",72704,1,1387700,1387700,0,-1387700,-1387700,700,700
"324",72706,1,1369000,1369000,0,-1369000,-1369000,19400,19400
"325",72707,1,1376700,1376700,0,-1376700,-1376700,11700,11700
"326",72708,1,1386700,1386700,0,-1386700,-1386700,1700,1700
"327",72709,1,1386300,1386300,0,-1386300,-1386300,2100,2100
"328",72710,1,1388300,1388300,0,-1388300,-1388300,100,100
"329",72711,1,1386300,1386300,0,-1386300,-1386300,2100,2100
"330",72712,1,1375600,1375600,0,-1375600,-1375600,12800,12800
"331",72713,1,1376600,1376600,0,-1376600,-1376600,11800,11800
"332",72715,1,1385000,1385000,0,-1385000,-1385000,3400,3400
"333",72716,1,1384500,1384500,0,-1384500,-1384500,3900,3900
"334",72719,1,1370800,1370800,0,-1370800,-1370800,17600,17600
"335",72720,1,1383100,1383100,0,-1383100,-1383100,5300,5300
"336",72722,1,1382300,1382300,0,-1382300,-1382300,6100,6100
"337",72723,1,1384400,1384400,0,-1384400,-1384400,4000,4000
"338",72724,1,1369500,1369500,0,-1369500,-1369500,18900,18900
"339",72725,1,1384100,1384100,0,-1384100,-1384100,4300,4300
"340",72726,1,1387700,1387700,0,-1387700,-1387700,700,700
"341",72727,1,1378700,1378700,0,-1378700,-1378700,9700,9700
"342",72729,1,1386100,1386100,0,-1386100,-1386100,2300,2300
"343",72731,1,1376600,1376600,0,-1376600,-1376600,11800,11800
"344",72733,1,1387200,1387200,0,-1387200,-1387200,1200,1200
"345",72734,1,1388000,1388000,0,-1388000,-1388000,400,400
"346",72735,1,1388000,1388000,0,-1388000,-1388000,400,400
"347",72736,1,1368700,1368700,0,-1368700,-1368700,19700,19700
"348",72737,1,1384200,1384200,0,-1384200,-1384200,4200,4200
"349",72738,1,1367600,1367600,0,-1367600,-1367600,20800,20800
"350",72739,1,1385400,1385400,0,-1385400,-1385400,3000,3000
"351",72740,1,1387700,1387700,0,-1387700,-1387700,700,700
"352",72744,1,1386500,1386500,0,-1386500,-1386500,1900,1900
"353",72745,1,1382700,1382700,0,-1382700,-1382700,5700,5700
"354",72746,1,1374700,1374700,0,-1374700,-1374700,13700,13700
"355",72750,1,1386000,1386000,0,-1386000,-1386000,2400,2400
"356",72751,1,1358100,1358100,0,-1358100,-1358100,30300,30300
"357",72752,1,1366300,1366300,0,-1366300,-1366300,22100,22100
"358",72756,1,1383700,1383700,0,-1383700,-1383700,4700,4700
"359",72757,1,1380000,1380000,0,-1380000,-1380000,8400,8400
"360",72758,1,1319800,1319800,0,-1319800,-1319800,68600,68600
"361",72760,1,1385500,1385500,0,-1385500,-1385500,2900,2900
"362",72761,1,1374900,1374900,0,-1374900,-1374900,13500,13500
"363",72762,1,1382900,1382900,0,-1382900,-1382900,5500,5500
"364",72763,1,1348800,1348800,0,-1348800,-1348800,39600,39600
"365",72765,1,1386300,1386300,0,-1386300,-1386300,2100,2100
"366",72767,1,1388300,1388300,0,-1388300,-1388300,100,100
"367",72768,1,1384000,1384000,0,-1384000,-1384000,4400,4400
"368",72770,1,1388100,1388100,0,-1388100,-1388100,300,300
"369",72771,1,1387400,1387400,0,-1387400,-1387400,1000,1000
"370",72774,1,1387600,1387600,0,-1387600,-1387600,800,800
"371",72775,1,1387700,1387700,0,-1387700,-1387700,700,700
"372",72777,1,1356000,1356000,0,-1356000,-1356000,32400,32400
"373",72778,1,1231700,1231700,0,-1231700,-1231700,156700,156700
"374",72779,1,1385800,1385800,0,-1385800,-1385800,2600,2600
"375",72782,1,1375200,1375200,0,-1375200,-1375200,13200,13200
"376",72783,1,1352800,1352800,0,-1352800,-1352800,35600,35600
"377",72785,1,1339300,1339300,0,-1339300,-1339300,49100,49100
"378",72786,1,1381900,1381900,0,-1381900,-1381900,6500,6500
"379",72787,1,1380500,1380500,0,-1380500,-1380500,7900,7900
"380",72788,1,1386700,1386700,0,-1386700,-1386700,1700,1700
"381",72789,1,1382900,1382900,0,-1382900,-1382900,5500,5500
"382",72790,1,1387800,1387800,0,-1387800,-1387800,600,600
"383",72791,1,1386200,1386200,0,-1386200,-1386200,2200,2200
"384",72792,1,1371700,1371700,0,-1371700,-1371700,16700,16700
"385",72793,1,1385000,1385000,0,-1385000,-1385000,3400,3400
"386",72794,1,1385300,1385300,0,-1385300,-1385300,3100,3100
"387",72800,1,1335300,1335300,0,-1335300,-1335300,53100,53100
"388",72801,1,1386600,1386600,0,-1386600,-1386600,1800,1800
"389",72802,1,1373000,1373000,0,-1373000,-1373000,15400,15400
"390",72805,1,1321700,1321700,0,-1321700,-1321700,66700,66700
"391",72807,1,1376000,1376000,0,-1376000,-1376000,12400,12400
"392",72808,1,1387200,1387200,0,-1387200,-1387200,1200,1200
"393",72810,1,1387900,1387900,0,-1387900,-1387900,500,500
"394",72811,1,1388000,1388000,0,-1388000,-1388000,400,400
"395",72814,1,1384300,1384300,0,-1384300,-1384300,4100,4100
"396",72816,1,1388100,1388100,0,-1388100,-1388100,300,300
"397",72817,1,1367200,1367200,0,-1367200,-1367200,21200,21200
"398",72819,1,1386700,1386700,0,-1386700,-1386700,1700,1700
"399",72820,1,1382900,1382900,0,-1382900,-1382900,5500,5500
"400",72824,1,1362400,1362400,0,-1362400,-1362400,26000,26000
"401",72825,1,1385100,1385100,0,-1385100,-1385100,3300,3300
"402",72826,1,1293400,1293400,0,-1293400,-1293400,95000,95000
"403",72828,1,1367600,1367600,0,-1367600,-1367600,20800,20800
"404",72829,1,1372400,1372400,0,-1372400,-1372400,16000,16000
"405",72831,1,1266200,1266200,0,-1266200,-1266200,122200,122200
"406",72832,1,1373800,1373800,0,-1373800,-1373800,14600,14600
"407",72833,1,1374700,1374700,0,-1374700,-1374700,13700,13700
"408",72835,1,1363900,1363900,0,-1363900,-1363900,24500,24500
"409",72837,1,1377700,1377700,0,-1377700,-1377700,10700,10700
"410",72838,1,1383200,1383200,0,-1383200,-1383200,5200,5200
"411",72839,1,1370900,1370900,0,-1370900,-1370900,17500,17500
"412",72840,1,1385700,1385700,0,-1385700,-1385700,2700,2700
"413",72841,1,1388200,1388200,0,-1388200,-1388200,200,200
"414",72842,1,1386500,1386500,0,-1386500,-1386500,1900,1900
"415",72843,1,1386600,1386600,0,-1386600,-1386600,1800,1800
"416",72844,1,1383000,1383000,0,-1383000,-1383000,5400,5400
"417",72846,1,1370500,1370500,0,-1370500,-1370500,17900,17900
"418",72847,1,1387900,1387900,0,-1387900,-1387900,500,500
"419",72848,1,1370200,1370200,0,-1370200,-1370200,18200,18200
"420",72850,1,1376100,1376100,0,-1376100,-1376100,12300,12300
"421",72852,1,1388400,1388400,0,-1388400,-1388400,0,0
"422",72854,1,1377200,1377200,0,-1377200,-1377200,11200,11200
"423",72855,1,1374400,1374400,0,-1374400,-1374400,14000,14000
"424",72857,1,1387600,1387600,0,-1387600,-1387600,800,800
"425",72859,1,1374000,1374000,0,-1374000,-1374000,14400,14400
"426",72861,1,1375600,1375600,0,-1375600,-1375600,12800,12800
"427",72862,1,1386300,1386300,0,-1386300,-1386300,2100,2100
"428",72869,1,1378900,1378900,0,-1378900,-1378900,9500,9500
"429",72872,1,1383400,1383400,0,-1383400,-1383400,5000,5000
"430",72873,1,1377900,1377900,0,-1377900,-1377900,10500,10500
"431",72875,1,1365900,1365900,0,-1365900,-1365900,22500,22500
"432",72878,1,1352800,1352800,0,-1352800,-1352800,35600,35600
"433",72879,1,1384500,1384500,0,-1384500,-1384500,3900,3900
"434",72880,1,1365400,1365400,0,-1365400,-1365400,23000,23000
"435",72881,1,1388200,1388200,0,-1388200,-1388200,200,200
"436",72882,1,1375100,1375100,0,-1375100,-1375100,13300,13300
"437",72883,1,1385900,1385900,0,-1385900,-1385900,2500,2500
"438",72884,1,1386300,1386300,0,-1386300,-1386300,2100,2100
"439",72885,1,1387900,1387900,0,-1387900,-1387900,500,500
"440",72887,1,1347700,1347700,0,-1347700,-1347700,40700,40700
"441",72889,1,1369400,1369400,0,-1369400,-1369400,19000,19000
"442",72890,1,1346500,1346500,0,-1346500,-1346500,41900,41900
"443",72891,1,1376500,1376500,0,-1376500,-1376500,11900,11900
"444",72892,1,1384500,1384500,0,-1384500,-1384500,3900,3900
"445",72893,1,1381600,1381600,0,-1381600,-1381600,6800,6800
"446",72894,1,1380200,1380200,0,-1380200,-1380200,8200,8200
"447",72895,1,1377000,1377000,0,-1377000,-1377000,11400,11400
"448",72896,1,1384200,1384200,0,-1384200,-1384200,4200,4200
"449",72897,1,1386800,1386800,0,-1386800,-1386800,1600,1600
"450",72900,1,1377100,1377100,0,-1377100,-1377100,11300,11300
"451",72901,1,1370300,1370300,0,-1370300,-1370300,18100,18100
"452",72902,1,1370600,1370600,0,-1370600,-1370600,17800,17800
"453",72904,1,1366200,1366200,0,-1366200,-1366200,22200,22200
"454",72905,1,1386300,1386300,0,-1386300,-1386300,2100,2100
"455",72906,1,1373300,1373300,0,-1373300,-1373300,15100,15100
"456",72907,1,1387800,1387800,0,-1387800,-1387800,600,600
"457",72909,1,1246100,1246100,0,-1246100,-1246100,142300,142300
"458",72911,1,1350300,1350300,0,-1350300,-1350300,38100,38100
"459",72913,1,1386500,1386500,0,-1386500,-1386500,1900,1900
"460",72914,1,1388200,1388200,0,-1388200,-1388200,200,200
"461",72916,1,1386700,1386700,0,-1386700,-1386700,1700,1700
"462",72917,1,1366800,1366800,0,-1366800,-1366800,21600,21600
"463",72919,1,1387400,1387400,0,-1387400,-1387400,1000,1000
"464",72920,1,1380600,1380600,0,-1380600,-1380600,7800,7800
"465",72921,1,1387500,1387500,0,-1387500,-1387500,900,900
"466",72922,1,1380200,1380200,0,-1380200,-1380200,8200,8200
"467",72923,1,1387900,1387900,0,-1387900,-1387900,500,500
"468",72925,1,1378200,1378200,0,-1378200,-1378200,10200,10200
"469",72927,1,1387100,1387100,0,-1387100,-1387100,1300,1300
"470",72928,1,1381100,1381100,0,-1381100,-1381100,7300,7300
"471",72929,1,1381600,1381600,0,-1381600,-1381600,6800,6800
"472",72930,1,1387000,1387000,0,-1387000,-1387000,1400,1400
"473",72931,1,1377300,1377300,0,-1377300,-1377300,11100,11100
"474",72934,1,1385500,1385500,0,-1385500,-1385500,2900,2900
"475",72935,1,1364300,1364300,0,-1364300,-1364300,24100,24100
"476",72936,1,1325000,1325000,0,-1325000,-1325000,63400,63400
"477",72937,1,1385800,1385800,0,-1385800,-1385800,2600,2600
"478",72938,1,1386100,1386100,0,-1386100,-1386100,2300,2300
"479",72940,1,1376800,1376800,0,-1376800,-1376800,11600,11600
"480",72943,1,1381400,1381400,0,-1381400,-1381400,7000,7000
"481",72944,1,1384100,1384100,0,-1384100,-1384100,4300,4300
"482",72945,1,1382600,1382600,0,-1382600,-1382600,5800,5800
"483",72946,1,1385700,1385700,0,-1385700,-1385700,2700,2700
"484",72947,1,1380400,1380400,0,-1380400,-1380400,8000,8000
"485",72948,1,1383900,1383900,0,-1383900,-1383900,4500,4500
"486",72949,1,1248300,1248300,0,-1248300,-1248300,140100,140100
"487",72952,1,1382200,1382200,0,-1382200,-1382200,6200,6200
"488",72954,1,1367400,1367400,0,-1367400,-1367400,21000,21000
"489",72956,1,1386100,1386100,0,-1386100,-1386100,2300,2300
"490",72959,1,1382400,1382400,0,-1382400,-1382400,6000,6000
"491",72960,1,1387200,1387200,0,-1387200,-1387200,1200,1200
"492",72962,1,1375300,1375300,0,-1375300,-1375300,13100,13100
"493",72965,1,1054300,1054300,0,-1054300,-1054300,334100,334100
"494",72966,1,1381400,1381400,0,-1381400,-1381400,7000,7000
"495",72969,1,1385300,1385300,0,-1385300,-1385300,3100,3100
"496",72970,1,1387800,1387800,0,-1387800,-1387800,600,600
"497",72971,1,1384300,1384300,0,-1384300,-1384300,4100,4100
"498",72973,1,1361800,1361800,0,-1361800,-1361800,26600,26600
"499",72974,1,1386600,1386600,0,-1386600,-1386600,1800,1800
"500",72976,1,1379100,1379100,0,-1379100,-1379100,9300,9300
"501",72977,1,1387100,1387100,0,-1387100,-1387100,1300,1300
"502",72978,1,1377600,1377600,0,-1377600,-1377600,10800,10800
"503",72980,1,1351600,1351600,0,-1351600,-1351600,36800,36800
"504",72981,1,1379800,1379800,0,-1379800,-1379800,8600,8600
"505",72982,1,1383700,1383700,0,-1383700,-1383700,4700,4700
"506",72983,1,1386300,1386300,0,-1386300,-1386300,2100,2100
"507",72985,1,1381900,1381900,0,-1381900,-1381900,6500,6500
"508",72986,1,1386400,1386400,0,-1386400,-1386400,2000,2000
"509",72987,1,1387200,1387200,0,-1387200,-1387200,1200,1200
"510",72988,1,1359700,1359700,0,-1359700,-1359700,28700,28700
"511",72990,1,1382500,1382500,0,-1382500,-1382500,5900,5900
"512",72991,1,1381200,1381200,0,-1381200,-1381200,7200,7200
"513",72992,1,1381800,1381800,0,-1381800,-1381800,6600,6600
"514",72993,1,1367500,1367500,0,-1367500,-1367500,20900,20900
"515",72994,1,1356100,1356100,0,-1356100,-1356100,32300,32300
"516",72995,1,1369600,1369600,0,-1369600,-1369600,18800,18800
"517",72996,1,1329000,1329000,0,-1329000,-1329000,59400,59400
"518",72997,1,1372000,1372000,0,-1372000,-1372000,16400,16400
"519",72999,1,1368900,1368900,0,-1368900,-1368900,19500,19500
"520",73000,1,1382000,1382000,0,-1382000,-1382000,6400,6400
"521",73001,1,1328400,1328400,0,-1328400,-1328400,60000,60000
"522",73002,1,1376500,1376500,0,-1376500,-1376500,11900,11900
"523",73004,1,1378700,1378700,0,-1378700,-1378700,9700,9700
"524",73005,1,1377700,1377700,0,-1377700,-1377700,10700,10700
"525",73006,1,1385500,1385500,0,-1385500,-1385500,2900,2900
"526",73007,1,1373300,1373300,0,-1373300,-1373300,15100,15100
"527",73008,1,1384600,1384600,0,-1384600,-1384600,3800,3800
"528",73012,1,1387700,1387700,0,-1387700,-1387700,700,700
"529",73013,1,1381000,1381000,0,-1381000,-1381000,7400,7400
"530",73018,1,1366200,1366200,0,-1366200,-1366200,22200,22200
"531",73021,1,1387400,1387400,0,-1387400,-1387400,1000,1000
"532",73027,1,1381800,1381800,0,-1381800,-1381800,6600,6600
"533",73032,1,1348900,1348900,0,-1348900,-1348900,39500,39500
"534",73035,1,1388000,1388000,0,-1388000,-1388000,400,400
"535",73036,1,1377000,1377000,0,-1377000,-1377000,11400,11400
"536",73037,1,1376100,1376100,0,-1376100,-1376100,12300,12300
"537",73038,1,1386800,1386800,0,-1386800,-1386800,1600,1600
"538",73040,1,1379500,1379500,0,-1379500,-1379500,8900,8900
"539",73041,1,1365300,1365300,0,-1365300,-1365300,23100,23100
"540",73042,1,1382500,1382500,0,-1382500,-1382500,5900,5900
"541",73044,1,1383600,1383600,0,-1383600,-1383600,4800,4800
"542",73045,1,1309700,1309700,0,-1309700,-1309700,78700,78700
"543",73047,1,1355800,1355800,0,-1355800,-1355800,32600,32600
"544",73051,1,1369500,1369500,0,-1369500,-1369500,18900,18900
"545",73052,1,1380200,1380200,0,-1380200,-1380200,8200,8200
"546",73053,1,1370600,1370600,0,-1370600,-1370600,17800,17800
"547",73054,1,1371200,1371200,0,-1371200,-1371200,17200,17200
"548",73055,1,1386500,1386500,0,-1386500,-1386500,1900,1900
"549",73057,1,1384400,1384400,0,-1384400,-1384400,4000,4000
"550",73059,1,1387500,1387500,0,-1387500,-1387500,900,900
"551",73061,1,1371900,1371900,0,-1371900,-1371900,16500,16500
"552",73062,1,1379700,1379700,0,-1379700,-1379700,8700,8700
"553",73064,1,1382900,1382900,0,-1382900,-1382900,5500,5500
"554",73065,1,1387300,1387300,0,-1387300,-1387300,1100,1100
"555",73067,1,1377500,1377500,0,-1377500,-1377500,10900,10900
"556",73068,1,1378900,1378900,0,-1378900,-1378900,9500,9500
"557",73073,1,1359200,1359200,0,-1359200,-1359200,29200,29200
"558",73075,1,1381000,1381000,0,-1381000,-1381000,7400,7400
"559",73076,1,1371300,1371300,0,-1371300,-1371300,17100,17100
"560",73077,1,1362100,1362100,0,-1362100,-1362100,26300,26300
"561",73079,1,1379600,1379600,0,-1379600,-1379600,8800,8800
"562",73080,1,1383600,1383600,0,-1383600,-1383600,4800,4800
"563",73081,1,1331700,1331700,0,-1331700,-1331700,56700,56700
"564",73082,1,1384800,1384800,0,-1384800,-1384800,3600,3600
"565",73083,1,1387200,1387200,0,-1387200,-1387200,1200,1200
"566",73084,1,1373200,1373200,0,-1373200,-1373200,15200,15200
"567",73085,1,1365400,1365400,0,-1365400,-1365400,23000,23000
"568",73086,1,1386200,1386200,0,-1386200,-1386200,2200,2200
"569",73087,1,1370700,1370700,0,-1370700,-1370700,17700,17700
"570",73088,1,1385200,1385200,0,-1385200,-1385200,3200,3200
"571",73089,1,1368400,1368400,0,-1368400,-1368400,20000,20000
"572",73093,1,1384200,1384200,0,-1384200,-1384200,4200,4200
"573",73095,1,1377500,1377500,0,-1377500,-1377500,10900,10900
"574",73096,1,1387000,1387000,0,-1387000,-1387000,1400,1400
"575",73097,1,1385500,1385500,0,-1385500,-1385500,2900,2900
"576",73098,1,1383900,1383900,0,-1383900,-1383900,4500,4500
"577",73099,1,1360200,1360200,0,-1360200,-1360200,28200,28200
"578",73101,1,1385100,1385100,0,-1385100,-1385100,3300,3300
"579",73102,1,1383200,1383200,0,-1383200,-1383200,5200,5200
"580",73103,1,1384100,1384100,0,-1384100,-1384100,4300,4300
"581",73105,1,1382400,1382400,0,-1382400,-1382400,6000,6000
"582",73107,1,1367400,1367400,0,-1367400,-1367400,21000,21000
"583",73109,1,1382200,1382200,0,-1382200,-1382200,6200,6200
"584",73110,1,1384500,1384500,0,-1384500,-1384500,3900,3900
"585",73113,1,1350500,1350500,0,-1350500,-1350500,37900,37900
"586",73115,1,1385000,1385000,0,-1385000,-1385000,3400,3400
"587",73116,1,1387000,1387000,0,-1387000,-1387000,1400,1400
"588",73117,1,1387800,1387800,0,-1387800,-1387800,600,600
"589",73118,1,1376500,1376500,0,-1376500,-1376500,11900,11900
"590",73119,1,1370200,1370200,0,-1370200,-1370200,18200,18200
"591",73120,1,1370500,1370500,0,-1370500,-1370500,17900,17900
"592",73121,1,1387800,1387800,0,-1387800,-1387800,600,600
"593",73124,1,1381400,1381400,0,-1381400,-1381400,7000,7000
"594",73125,1,1341100,1341100,0,-1341100,-1341100,47300,47300
"595",73126,1,1388200,1388200,0,-1388200,-1388200,200,200
"596",73127,1,1385400,1385400,0,-1385400,-1385400,3000,3000
"597",73129,1,1356400,1356400,0,-1356400,-1356400,32000,32000
"598",73134,1,1372600,1372600,0,-1372600,-1372600,15800,15800
"599",73136,1,1372400,1372400,0,-1372400,-1372400,16000,16000
"600",73139,1,1381100,1381100,0,-1381100,-1381100,7300,7300
"601",73140,1,1385200,1385200,0,-1385200,-1385200,3200,3200
"602",73141,1,1174000,1174000,0,-1174000,-1174000,214400,214400
"603",73143,1,1376300,1376300,0,-1376300,-1376300,12100,12100
"604",73144,1,1371100,1371100,0,-1371100,-1371100,17300,17300
"605",73145,1,1366500,1366500,0,-1366500,-1366500,21900,21900
"606",73146,1,1346000,1346000,0,-1346000,-1346000,42400,42400
"607",73147,1,1386000,1386000,0,-1386000,-1386000,2400,2400
"608",73150,1,1386100,1386100,0,-1386100,-1386100,2300,2300
"609",73151,1,1375600,1375600,0,-1375600,-1375600,12800,12800
"610",73152,1,1350700,1350700,0,-1350700,-1350700,37700,37700
"611",73153,1,1380000,1380000,0,-1380000,-1380000,8400,8400
"612",73154,1,1385800,1385800,0,-1385800,-1385800,2600,2600
"613",73155,1,1386300,1386300,0,-1386300,-1386300,2100,2100
"614",73156,1,1386300,1386300,0,-1386300,-1386300,2100,2100
"615",73157,1,1356600,1356600,0,-1356600,-1356600,31800,31800
"616",73159,1,1360800,1360800,0,-1360800,-1360800,27600,27600
"617",73160,1,1384900,1384900,0,-1384900,-1384900,3500,3500
"618",73161,1,1362600,1362600,0,-1362600,-1362600,25800,25800
"619",73162,1,1388300,1388300,0,-1388300,-1388300,100,100
"620",73163,1,1379400,1379400,0,-1379400,-1379400,9000,9000
"621",73164,1,1387600,1387600,0,-1387600,-1387600,800,800
"622",73165,1,1388300,1388300,0,-1388300,-1388300,100,100
"623",73167,1,1365600,1365600,0,-1365600,-1365600,22800,22800
"624",73168,1,1380600,1380600,0,-1380600,-1380600,7800,7800
"625",73169,1,1386600,1386600,0,-1386600,-1386600,1800,1800
"626",73170,1,1388300,1388300,0,-1388300,-1388300,100,100
"627",73171,1,1360500,1360500,0,-1360500,-1360500,27900,27900
"628",73172,1,1361900,1361900,0,-1361900,-1361900,26500,26500
"629",73173,1,1387400,1387400,0,-1387400,-1387400,1000,1000
"630",73174,1,1385800,1385800,0,-1385800,-1385800,2600,2600
"631",73175,1,1387900,1387900,0,-1387900,-1387900,500,500
"632",73176,1,1386500,1386500,0,-1386500,-1386500,1900,1900
"633",73177,1,1376500,1376500,0,-1376500,-1376500,11900,11900
"634",73178,1,1381900,1381900,0,-1381900,-1381900,6500,6500
"635",73179,1,1298200,1298200,0,-1298200,-1298200,90200,90200
"636",73180,1,1385100,1385100,0,-1385100,-1385100,3300,3300
"637",73181,1,1386400,1386400,0,-1386400,-1386400,2000,2000
"638",73184,1,1380400,1380400,0,-1380400,-1380400,8000,8000
"639",73185,1,1382600,1382600,0,-1382600,-1382600,5800,5800
"640",73186,1,1375600,1375600,0,-1375600,-1375600,12800,12800
"641",73187,1,1371200,1371200,0,-1371200,-1371200,17200,17200
"642",73188,1,1370000,1370000,0,-1370000,-1370000,18400,18400
"643",73191,1,1370400,1370400,0,-1370400,-1370400,18000,18000
"644",73192,1,1384900,1384900,0,-1384900,-1384900,3500,3500
"645",73193,1,1383900,1383900,0,-1383900,-1383900,4500,4500
"646",73194,1,1363700,1363700,0,-1363700,-1363700,24700,24700
"647",73196,1,1386300,1386300,0,-1386300,-1386300,2100,2100
"648",73198,1,1334100,1334100,0,-1334100,-1334100,54300,54300
"649",73199,1,1384600,1384600,0,-1384600,-1384600,3800,3800
"650",73200,1,1388000,1388000,0,-1388000,-1388000,400,400
"651",73201,1,1354700,1354700,0,-1354700,-1354700,33700,33700
"652",73202,1,1387500,1387500,0,-1387500,-1387500,900,900
"653",73203,1,1376000,1376000,0,-1376000,-1376000,12400,12400
"654",73204,1,1367800,1367800,0,-1367800,-1367800,20600,20600
"655",73205,1,1354400,1354400,0,-1354400,-1354400,34000,34000
"656",73206,1,1360600,1360600,0,-1360600,-1360600,27800,27800
"657",73207,1,1386200,1386200,0,-1386200,-1386200,2200,2200
"658",73208,1,1373200,1373200,0,-1373200,-1373200,15200,15200
"659",73209,1,1381900,1381900,0,-1381900,-1381900,6500,6500
"660",73211,1,1384400,1384400,0,-1384400,-1384400,4000,4000
"661",73212,1,1386200,1386200,0,-1386200,-1386200,2200,2200
"662",73213,1,1387500,1387500,0,-1387500,-1387500,900,900
"663",73214,1,1380200,1380200,0,-1380200,-1380200,8200,8200
"664",73215,1,1380400,1380400,0,-1380400,-1380400,8000,8000
"665",73216,1,1382300,1382300,0,-1382300,-1382300,6100,6100
"666",73217,1,1387300,1387300,0,-1387300,-1387300,1100,1100
"667",73218,1,1383900,1383900,0,-1383900,-1383900,4500,4500
"668",73219,1,1388400,1388400,0,-1388400,-1388400,0,0
"669",73220,1,1382200,1382200,0,-1382200,-1382200,6200,6200
"670",73221,1,1374500,1374500,0,-1374500,-1374500,13900,13900
"671",73222,1,1376000,1376000,0,-1376000,-1376000,12400,12400
"672",73225,1,1385000,1385000,0,-1385000,-1385000,3400,3400
"673",73226,1,1386200,1386200,0,-1386200,-1386200,2200,2200
"674",73228,1,1357400,1357400,0,-1357400,-1357400,31000,31000
"675",73230,1,1388200,1388200,0,-1388200,-1388200,200,200
"676",73231,1,1364500,1364500,0,-1364500,-1364500,23900,23900
"677",73232,1,1386300,1386300,0,-1386300,-1386300,2100,2100
"678",73233,1,1384000,1384000,0,-1384000,-1384000,4400,4400
"679",73235,1,1356800,1356800,0,-1356800,-1356800,31600,31600
"680",73236,1,1373000,1373000,0,-1373000,-1373000,15400,15400
"681",73237,1,1358400,1358400,0,-1358400,-1358400,30000,30000
"682",73238,1,1332300,1332300,0,-1332300,-1332300,56100,56100
"683",73239,1,1374000,1374000,0,-1374000,-1374000,14400,14400
"684",73240,1,1376000,1376000,0,-1376000,-1376000,12400,12400
"685",73241,1,1387400,1387400,0,-1387400,-1387400,1000,1000
"686",73243,1,1380200,1380200,0,-1380200,-1380200,8200,8200
"687",73244,1,1345100,1345100,0,-1345100,-1345100,43300,43300
"688",73245,1,1388400,1388400,0,-1388400,-1388400,0,0
"689",73246,1,1329900,1329900,0,-1329900,-1329900,58500,58500
"690",73247,1,1349800,1349800,0,-1349800,-1349800,38600,38600
"691",73248,1,1381400,1381400,0,-1381400,-1381400,7000,7000
"692",73249,1,1381100,1381100,0,-1381100,-1381100,7300,7300
"693",73250,1,1377800,1377800,0,-1377800,-1377800,10600,10600
"694",73252,1,1382800,1382800,0,-1382800,-1382800,5600,5600
"695",73253,1,1378100,1378100,0,-1378100,-1378100,10300,10300
"696",73254,1,1381400,1381400,0,-1381400,-1381400,7000,7000
"697",73255,1,1387300,1387300,0,-1387300,-1387300,1100,1100
"698",73258,1,1297200,1297200,0,-1297200,-1297200,91200,91200
"699",73260,1,1386000,1386000,0,-1386000,-1386000,2400,2400
"700",73261,1,1333400,1333400,0,-1333400,-1333400,55000,55000
"701",73262,1,1382500,1382500,0,-1382500,-1382500,5900,5900
"702",73263,1,1384400,1384400,0,-1384400,-1384400,4000,4000
"703",73264,1,1376500,1376500,0,-1376500,-1376500,11900,11900
"704",73266,1,1386200,1386200,0,-1386200,-1386200,2200,2200
"705",73267,1,1363700,1363700,0,-1363700,-1363700,24700,24700
"706",73268,1,1387100,1387100,0,-1387100,-1387100,1300,1300
"707",73269,1,1375700,1375700,0,-1375700,-1375700,12700,12700
"708",73270,1,1374500,1374500,0,-1374500,-1374500,13900,13900
"709",73271,1,1388100,1388100,0,-1388100,-1388100,300,300
"710",73272,1,1369400,1369400,0,-1369400,-1369400,19000,19000
"711",73273,1,1343700,1343700,0,-1343700,-1343700,44700,44700
"712",73274,1,1385400,1385400,0,-1385400,-1385400,3000,3000
"713",73275,1,1381700,1381700,0,-1381700,-1381700,6700,6700
"714",73277,1,1111300,1111300,0,-1111300,-1111300,277100,277100
"715",73278,1,1352800,1352800,0,-1352800,-1352800,35600,35600
"716",73279,1,1383500,1383500,0,-1383500,-1383500,4900,4900
"717",73280,1,1386100,1386100,0,-1386100,-1386100,2300,2300
"718",73281,1,1388200,1388200,0,-1388200,-1388200,200,200
"719",73283,1,1374700,1374700,0,-1374700,-1374700,13700,13700
"720",73284,1,1388300,1388300,0,-1388300,-1388300,100,100
"721",73285,1,1388200,1388200,0,-1388200,-1388200,200,200
"722",73286,1,1386600,1386600,0,-1386600,-1386600,1800,1800
"723",73287,1,1374900,1374900,0,-1374900,-1374900,13500,13500
"724",73289,1,1348800,1348800,0,-1348800,-1348800,39600,39600
"725",73290,1,1378800,1378800,0,-1378800,-1378800,9600,9600
"726",73291,1,1386800,1386800,0,-1386800,-1386800,1600,1600
"727",73292,1,1366200,1366200,0,-1366200,-1366200,22200,22200
"728",73293,1,1338600,1338600,0,-1338600,-1338600,49800,49800
"729",73296,1,1365900,1365900,0,-1365900,-1365900,22500,22500
